"","pid","PaDS1","PaDS2","PaDS3","PaDS4","PaDS5","Paranoia_Total","CMQ1","CMQ2","CMQ3","CMQ4","CMQ5","Conspiracy_Total","Crime_decile","Neighbourhood_Trust","Bias"
"1",1491499819,4,3,2,1,3,13,6,6,6,6,6,30,6,6,-0.0654843506931415
"2",1490725181,1,3,3,3,4,14,10,9,9,10,11,49,2,6,-0.428963105626168
"3",1520675683,3,3,3,3,3,15,6,6,6,6,6,30,2,6,0.642684729316485
"4",1491504705,2,3,3,2,2,12,7,6,5,3,6,27,2,3,0.642684729316485
"5",1565007740,4,2,4,3,4,17,4,7,8,5,6,30,2,5,-1.20805422690819
"6",1490680407,4,5,5,4,4,22,3,11,11,11,11,47,2,8,-0.428963105626168
"7",1490587055,3,3,3,3,3,15,6,6,6,6,6,30,1,6,-0.428963105626168
"8",1282295584,3,3,3,3,4,16,6,5,5,5,11,32,1,4,-1.20805422690819
"9",1491554459,3,2,1,1,2,9,4,4,3,3,4,18,1,5,-0.306198757933557
"10",1491505466,1,3,2,1,2,9,6,6,6,6,6,30,3,5,0.0384915671430424
"11",1491482491,1,5,4,2,4,16,9,8,7,7,7,38,2,5,-1.20805422690819
"12",1490752918,1,1,3,2,2,9,9,8,4,5,6,32,4,7,1.20900972678133
"13",1265607857,1,1,4,1,1,8,1,9,1,1,1,13,4,5,0.0384915671430424
"14",1491298425,4,4,3,2,4,17,5,8,6,6,7,32,6,5,0.0384915671430424
"15",1491622987,3,3,3,3,3,15,7,8,7,5,3,30,8,4,-0.306198757933557
"16",1580229287,4,5,3,4,4,20,9,8,8,7,5,37,1,4,0.246152097819666
"17",1491548057,1,3,4,1,3,12,9,8,7,6,9,39,2,3,0.897373278268519
"18",1490987061,1,4,5,2,3,15,11,10,8,7,11,47,4,4,1.12411354379732
"19",1490753827,4,4,4,4,4,20,6,6,6,6,6,30,3,6,-1.20805422690819
"20",1407826802,4,3,4,4,4,19,6,6,7,5,5,29,4,7,-0.929471654959171
"21",1491511559,1,2,2,1,2,8,8,9,9,8,8,42,1,6,0.642684729316485
"22",1490713897,1,1,1,1,1,5,9,7,5,6,7,34,8,2,0.585736829755712
"23",1491490021,1,3,3,1,3,11,6,6,6,6,8,32,7,5,0.642684729316485
"24",1307065948,1,1,3,1,5,11,6,11,6,1,1,25,1,2,-1.20805422690819
"25",1491204506,1,4,3,1,3,12,9,11,10,8,10,48,8,5,-1.20805422690819
"26",1479147629,1,3,4,3,3,14,7,8,6,5,1,27,8,8,-0.117326657113361
"27",1490746969,4,5,5,5,4,23,10,10,7,9,11,47,6,3,-0.740599554138976
"28",1490760585,1,1,2,1,3,8,5,7,3,7,6,28,1,5,0.0384915671430424
"29",1685097648,4,2,2,2,4,14,7,5,7,5,5,29,1,7,0.642684729316485
"30",1358858740,1,4,4,2,5,16,10,11,11,11,11,54,3,6,0.8833991365569
"31",1676029479,1,4,4,4,5,18,7,7,8,6,4,32,10,5,-1.20805422690819
"32",1491593340,1,1,3,1,3,9,8,9,6,6,9,38,2,6,0.161255914835654
"33",1566968953,1,3,2,2,3,11,10,10,5,9,10,44,3,4,-1.20805422690819
"34",1491554986,1,4,3,2,3,13,6,8,4,4,6,28,10,6,-1.20805422690819
"35",1491047045,2,4,4,3,3,16,8,8,8,8,8,40,6,5,-1.20805422690819
"36",1490602239,1,2,2,1,4,10,7,7,7,7,7,35,8,6,-0.136406391965533
"37",1490622582,3,2,4,2,3,14,6,7,6,7,6,32,2,6,-0.306198757933557
"38",1490577957,3,3,3,3,3,15,6,6,6,6,6,30,1,2,-0.740599554138976
"39",1490713156,1,4,3,1,1,10,11,11,8,11,11,52,1,2,-0.428963105626168
"40",1491576637,3,4,3,5,3,18,6,10,9,8,6,39,1,4,0.161255914835654
"41",1653240619,1,2,4,1,2,10,11,11,9,7,11,49,5,5,0.0384915671430424
"42",1490578373,2,1,3,1,1,8,11,11,1,6,11,40,1,8,0.8833991365569
"43",1072329704,3,4,3,4,3,17,9,9,9,8,10,45,2,7,-0.428963105626168
"44",1491778530,3,1,1,1,3,9,8,9,1,1,8,27,7,6,-0.617835206446364
"45",1345884405,1,1,1,1,1,5,2,2,2,2,2,10,3,8,0.8833991365569
"46",1207893979,1,3,3,2,1,10,10,7,7,7,7,38,10,6,-0.740599554138976
"47",1491665749,1,4,2,1,2,10,5,8,5,3,2,23,10,8,-1.05223600265178
"48",1490570948,1,1,2,1,2,7,10,8,9,4,9,40,2,5,1.47074229022351
"49",1491530056,1,1,1,1,1,5,8,10,7,7,7,39,4,8,1.47074229022351
"50",1491516068,1,4,3,2,4,14,11,7,8,8,9,43,3,6,-0.117326657113361
"51",1716243042,1,1,2,1,3,8,11,10,10,6,6,43,2,7,0.0384915671430424
"52",1491730938,2,2,1,1,2,8,6,8,9,6,9,38,1,6,0.161255914835654
"53",1490714419,4,4,3,2,3,16,6,6,8,6,6,32,6,6,0.161255914835654
"54",1490609198,1,1,1,1,1,5,9,7,6,2,2,26,4,8,0.401970322076069
"55",1491513899,4,3,4,3,4,18,4,5,5,6,6,26,3,5,-0.117326657113361
"56",1490659739,4,5,5,5,3,22,11,11,6,6,9,43,4,4,-1.20805422690819
"57",1490601828,1,1,1,1,2,6,4,5,4,4,3,20,1,2,0.0384915671430424
"58",1490579085,1,1,1,1,1,5,8,8,9,5,4,34,1,6,-0.929471654959171
"59",1491555474,1,5,4,5,5,20,6,6,6,6,6,30,6,2,-1.20805422690819
"60",1416766590,1,1,2,2,2,8,11,8,9,8,11,47,2,5,-0.617835206446364
"61",1490609696,4,3,2,1,2,12,8,7,8,8,7,38,2,6,1.47074229022351
"62",1468741240,3,2,3,3,2,13,6,6,6,5,6,29,3,6,-1.20805422690819
"63",1490729883,1,1,3,2,3,10,8,8,6,9,6,37,3,8,1.36482795103773
"64",1490695636,2,1,2,1,3,9,9,9,10,8,8,44,6,6,0.0384915671430424
"65",1573661361,1,1,2,1,3,8,7,9,8,6,5,35,8,7,-0.117326657113361
"66",1178936529,4,1,1,1,2,9,11,7,7,8,8,41,2,5,0.175230056547274
"67",1491498525,3,5,3,4,3,18,11,11,9,9,9,49,2,2,0.246152097819666
"68",1491716231,3,3,3,3,3,15,6,5,5,7,7,30,10,4,0.00543769057925059
"69",1490636181,1,1,1,1,1,5,7,9,8,9,11,44,10,8,-0.117326657113361
"70",1491589521,1,1,1,1,4,8,2,2,2,1,2,9,1,4,0.642684729316485
"71",1490731099,3,3,3,3,3,15,6,6,6,6,6,30,1,6,0.161255914835654
"72",1491762547,1,1,2,1,3,8,4,11,9,7,9,40,4,7,1.36482795103773
"73",1490660431,2,4,2,1,3,12,9,8,9,8,8,42,8,6,-0.117326657113361
"74",1536014167,3,3,2,3,3,14,9,9,9,9,9,45,8,2,-1.20805422690819
"75",1490570210,4,2,3,2,3,14,9,5,7,8,7,36,4,4,-0.428963105626168
"76",1312850811,3,2,3,2,3,13,6,6,6,6,6,30,4,4,-0.117326657113361
"77",1490620267,1,1,1,1,1,5,10,9,6,6,9,40,4,4,0.161255914835654
"78",1491314716,3,4,3,2,3,15,5,6,7,8,5,31,1,3,-0.306198757933557
"79",1490578158,1,1,1,1,1,5,11,8,6,1,1,27,4,3,0.0384915671430424
"80",1490615823,4,4,4,2,5,19,9,10,10,9,11,49,8,5,-0.740599554138976
"81",1716231650,4,4,4,2,2,16,9,9,8,4,4,34,2,3,0.00543769057925059
"82",1568135005,4,2,1,1,3,11,9,9,8,5,2,33,7,6,0.00543769057925059
"83",1279091711,2,3,2,2,3,12,5,8,3,6,5,27,10,4,0.642684729316485
"84",1490592817,3,3,3,3,3,15,8,9,9,10,10,46,9,8,-1.20805422690819
"85",1491550356,1,2,2,1,1,7,7,8,6,7,7,35,3,6,-0.117326657113361
"86",1490586873,4,5,4,4,5,22,7,7,7,8,7,36,7,8,-1.05223600265178
"87",1491770455,4,3,2,1,2,12,6,6,2,2,2,18,1,6,0.401970322076069
"88",1491301761,4,5,4,2,4,19,9,9,7,4,2,31,3,8,0.8833991365569
"89",1491639843,3,3,3,3,3,15,6,6,6,6,6,30,6,6,-1.05223600265178
"90",1692693283,2,4,3,4,4,17,5,5,4,4,5,23,6,6,-0.117326657113361
"91",1585306287,1,4,3,2,3,13,11,11,8,6,11,47,8,7,-1.20805422690819
"92",1491643027,1,2,2,1,2,8,9,9,6,4,6,34,9,8,1.47074229022351
"93",1490581102,2,2,3,1,2,10,1,5,3,1,1,11,9,8,0.642684729316485
"94",1544110166,2,3,3,2,2,12,6,6,5,5,6,28,10,3,-0.740599554138976
"95",1490586244,1,4,3,1,2,11,8,9,3,2,4,26,7,6,-1.20805422690819
"96",1490707301,1,2,1,1,1,6,2,4,5,7,8,26,10,6,0.00543769057925059
"97",1491571420,2,2,3,2,2,11,8,8,5,3,3,27,8,7,1.47074229022351
"98",1342143133,1,2,1,1,1,6,9,8,5,9,7,38,4,5,-0.117326657113361
"99",1490859390,3,3,3,3,3,15,6,3,8,6,6,29,5,4,-1.05223600265178
"100",1218544360,4,4,2,1,4,15,7,8,7,3,6,31,8,3,-0.0654843506931415
"101",1490678735,1,1,1,1,1,5,8,9,6,6,7,36,7,4,0.8833991365569
"102",1491530990,4,4,3,3,1,15,6,8,5,3,3,25,7,5,0.401970322076069
"103",1321185585,3,4,4,5,4,20,6,7,9,8,8,38,5,6,-0.0654843506931415
"104",1491579670,4,3,2,3,4,16,8,7,6,8,9,38,8,7,0.401970322076069
"105",1586491116,3,4,3,2,4,16,5,9,4,2,3,23,9,8,0.00543769057925059
"106",1491529617,1,4,4,1,4,14,8,8,8,8,6,38,6,8,0.246152097819666
"107",1652767239,1,2,2,1,2,8,10,7,9,6,8,40,8,6,0.0384915671430424
"108",1490593791,1,1,1,1,1,5,2,4,3,2,2,13,8,4,1.47074229022351
"109",1675583130,2,2,2,1,3,10,7,8,7,6,7,35,8,4,-1.20805422690819
"110",1490752978,3,2,3,1,4,13,2,4,7,2,2,17,2,6,-0.740599554138976
"111",1676344982,1,1,1,1,1,5,8,5,7,2,2,24,9,8,0.246152097819666
"112",1490580258,1,1,1,1,1,5,9,9,8,7,8,41,4,7,-0.740599554138976
"113",1491624195,1,1,1,1,3,7,9,9,7,3,7,35,5,8,0.175230056547274
"114",1491084628,2,2,2,2,2,10,8,8,7,7,8,38,9,5,-0.117326657113361
"115",1260439176,1,1,1,1,1,5,7,7,7,7,7,35,10,6,0.246152097819666
"116",1490701307,5,2,1,1,3,12,11,11,11,11,11,55,5,8,0.00543769057925059
"117",1491501913,2,2,2,1,3,10,7,7,8,7,7,36,9,8,0.642684729316485
"118",1491640989,1,1,4,1,1,8,9,8,10,6,3,36,8,7,1.47074229022351
"119",1490729182,2,3,3,2,3,13,8,8,2,3,6,27,5,6,1.47074229022351
"120",1644758570,4,5,4,3,2,18,9,7,10,9,11,46,5,6,0.727580912300496
"121",1491743642,1,1,2,1,1,6,8,8,6,4,3,29,3,7,1.36482795103773
"122",1491579422,1,3,3,1,4,12,11,11,11,11,11,55,8,2,-1.20805422690819
"123",1490715089,1,3,1,1,1,7,11,6,2,2,7,28,10,8,0.0384915671430424
"124",1491743938,4,3,3,1,1,12,8,5,4,2,4,23,8,8,0.246152097819666
"125",1704077724,2,4,2,3,3,14,5,8,6,4,7,30,6,7,-0.306198757933557
"126",1490806264,1,2,1,1,3,8,8,8,5,5,7,33,8,7,-0.740599554138976
"127",1067992883,3,1,1,1,1,7,11,9,2,5,2,29,5,8,0.401970322076069
"128",1418695802,1,2,3,1,4,11,3,7,2,2,2,16,9,6,-0.617835206446364
"129",1490729795,1,1,1,1,2,6,11,10,7,6,7,41,9,8,0.161255914835654
"130",1693541452,3,3,2,3,4,15,7,7,6,7,7,34,5,6,-1.05223600265178
"131",1490717012,4,4,4,4,4,20,2,3,4,5,6,20,5,6,1.47074229022351
"132",1298764760,3,4,3,3,4,17,6,9,6,6,6,33,7,2,-0.740599554138976
"133",1400635817,1,4,3,3,2,13,9,7,5,3,3,27,10,7,0.0384915671430424
"134",1490630583,3,3,3,3,3,15,7,6,6,6,6,31,10,6,0.00543769057925059
"135",1457733673,4,3,4,4,4,19,6,6,8,7,6,33,9,2,-1.20805422690819
"136",1490593104,1,1,1,1,2,6,2,8,2,1,1,14,8,6,-0.617835206446364
"137",1655755274,1,2,3,1,3,10,9,10,6,7,11,43,4,8,0.727580912300496
"138",1491621315,1,1,1,1,1,5,7,8,9,6,10,40,2,5,-0.117326657113361
"139",1620257786,3,2,3,3,3,14,11,9,8,6,8,42,3,6,0.0384915671430424
"140",1491780049,3,4,2,2,3,14,9,4,6,4,7,30,8,6,0.401970322076069
"141",1354618143,1,3,4,1,3,12,7,9,7,6,5,34,2,7,0.175230056547274
"142",1311631073,5,4,5,2,4,20,11,11,10,9,8,49,4,5,-0.306198757933557
"143",1490583546,1,1,1,1,1,5,7,7,4,7,7,32,8,6,0.8833991365569
"144",1216554760,5,4,4,2,3,18,11,9,6,6,6,38,4,4,0.274100381242905
"145",1318169604,1,1,1,1,3,7,9,9,8,8,6,40,4,6,-1.20805422690819
"146",1491499921,3,3,3,3,3,15,6,6,6,6,6,30,6,7,-1.20805422690819
"147",1491527432,1,5,3,1,4,14,11,11,6,6,6,40,6,2,-1.20805422690819
"148",1491060025,1,5,5,1,4,16,6,5,8,6,6,31,7,2,-1.20805422690819
"149",1490731893,1,2,2,2,4,11,8,7,9,8,8,40,10,6,0.401970322076069
"150",1490604240,1,2,3,1,2,9,6,5,4,4,4,23,6,6,-0.428963105626168
"151",1490690831,2,3,4,3,3,15,4,9,7,9,10,39,3,6,-1.20805422690819
"152",1713392415,3,3,3,3,3,15,7,5,8,5,6,31,1,2,0.8833991365569
"153",1531896098,3,3,3,3,3,15,6,10,8,8,9,41,3,2,-1.20805422690819
"154",1491494347,3,1,3,1,1,9,11,9,8,7,10,45,3,7,1.47074229022351
"155",1491115010,1,2,1,1,2,7,6,6,6,6,6,30,4,2,-0.207328433237925
"156",1218492856,1,3,1,1,3,9,9,6,9,6,6,36,9,8,0.727580912300496
"157",1490758145,1,1,1,4,4,11,6,11,3,3,3,26,9,6,0.401970322076069
"158",1491506356,1,1,1,1,2,6,9,8,7,8,6,38,9,8,0.175230056547274
"159",1597280252,1,1,1,1,1,5,2,4,2,1,1,10,5,6,-0.740599554138976
"160",1491617735,1,2,1,1,1,6,9,8,9,2,4,32,7,7,0.161255914835654
"161",1713779558,4,3,3,3,1,14,6,9,8,4,4,31,7,2,-1.05223600265178
"162",1490753199,3,3,3,3,3,15,6,5,6,6,6,29,1,2,-1.20805422690819
"163",1491529411,1,1,2,2,4,10,5,7,7,6,7,32,5,4,0.642684729316485
"164",1490674591,4,2,4,1,4,15,7,9,8,4,7,35,10,5,-1.20805422690819
"165",1490639752,5,4,4,3,4,20,9,7,8,4,7,35,2,8,-0.117326657113361
"166",1491310441,3,2,3,1,2,11,7,8,4,2,4,25,9,3,0.161255914835654
"167",1491773845,1,1,1,1,1,5,3,6,4,1,1,15,1,4,1.47074229022351
"168",1491744860,1,1,1,1,1,5,8,6,7,7,7,35,3,7,0.642684729316485
"169",1335975013,2,4,3,2,4,15,4,8,9,8,7,36,8,5,0.486866505060081
"170",1491143893,1,1,2,1,1,6,10,6,9,6,6,37,7,8,0.0384915671430424
"171",1491531831,1,4,4,4,4,17,6,6,6,6,6,30,6,7,1.47074229022351
"172",1490725665,2,4,4,4,4,18,8,8,6,6,6,34,4,6,-1.20805422690819
"173",1491578962,4,2,2,2,4,14,8,8,8,7,6,37,6,6,1.47074229022351
"174",1562003843,2,4,5,5,4,20,6,6,6,6,6,30,5,2,-1.20805422690819
"175",1260325350,1,1,4,1,3,10,9,8,6,6,6,35,6,2,1.12411354379732
"176",1518483718,3,3,3,3,4,16,4,7,6,7,7,31,6,6,0.401970322076069
"177",1341152810,1,3,2,1,4,11,3,9,2,1,1,16,6,3,-0.428963105626168
"178",1520494494,2,4,3,1,2,12,11,9,8,6,7,41,8,4,0.642684729316485
"179",1491492125,3,1,1,1,1,7,9,8,8,8,8,41,9,8,0.642684729316485
"180",1290116465,2,3,2,2,2,11,7,7,6,5,6,31,7,4,-0.117326657113361
"181",1490570436,2,4,1,1,4,12,3,7,3,2,2,17,7,3,0.00543769057925059
"182",1490578007,1,3,1,1,2,8,8,9,5,2,1,25,5,6,0.0384915671430424
"183",1491178375,1,1,1,1,1,5,8,7,6,4,4,29,9,7,0.727580912300496
"184",1564187350,1,3,2,1,4,11,8,8,9,9,7,41,7,8,-1.20805422690819
"185",1491180247,3,3,3,1,2,12,6,7,6,6,6,31,6,6,-1.20805422690819
"186",1571806915,1,1,1,1,2,6,11,7,8,5,5,36,9,6,1.36482795103773
"187",1490708208,1,3,3,3,4,14,11,8,10,10,11,50,10,3,-0.617835206446364
"188",1491776474,2,3,3,3,3,14,6,8,8,6,8,36,6,6,-0.117326657113361
"189",1491513056,2,2,2,2,3,11,2,7,4,2,2,17,10,6,0.161255914835654
"190",1491754847,3,1,1,1,1,7,7,6,7,7,6,33,4,6,-0.617835206446364
"191",1491777283,2,2,1,1,3,9,6,8,6,2,5,27,9,8,1.12411354379732
"192",1490563046,1,1,1,1,3,7,8,8,9,9,8,42,10,7,0.161255914835654
"193",1530412491,3,5,3,3,4,18,7,8,6,6,6,33,9,7,0.0384915671430424
"194",1602160595,3,3,2,3,3,14,8,8,8,6,5,35,6,4,-1.08528987921557
"195",1490659872,2,2,2,2,3,11,7,7,9,9,9,41,10,6,1.47074229022351
"196",1536265106,1,1,3,1,2,8,5,10,9,6,7,37,5,8,1.36482795103773
"197",1490591481,1,1,1,1,1,5,9,10,9,9,8,45,3,8,0.642684729316485
"198",1491631039,1,1,1,1,1,5,4,5,7,5,5,26,10,3,0.0384915671430424
"199",1491496963,3,4,4,2,4,17,10,10,9,6,6,41,9,8,-1.20805422690819
"200",1491740717,1,1,1,1,1,5,11,11,7,7,7,43,2,6,1.36482795103773
"201",1491743950,3,3,3,3,3,15,7,6,7,6,6,32,6,4,-0.136406391965533
"202",1491555157,5,4,2,2,4,17,7,8,6,5,7,33,6,5,-1.20805422690819
"203",1347269046,1,2,3,3,2,11,9,10,4,7,9,39,5,5,-0.117326657113361
"204",1613170293,1,4,2,1,1,9,8,6,9,8,6,37,1,5,0.246152097819666
"205",1707678658,3,3,4,2,2,14,7,8,7,9,9,40,7,5,-1.20805422690819
"206",1491518162,1,3,1,1,3,9,11,11,8,6,11,47,6,7,0.486866505060081
"207",1627389564,1,1,1,1,1,5,5,6,6,4,4,25,3,6,1.47074229022351
"208",1491599138,1,3,1,1,3,9,6,6,3,3,3,21,7,6,0.642684729316485
"209",1490600005,3,4,4,3,3,17,7,7,6,7,7,34,7,8,0.00543769057925059
"210",1491240708,4,4,3,3,3,17,7,8,7,7,7,36,7,3,-0.117326657113361
"211",1490803395,4,4,2,4,4,18,10,4,3,9,9,35,3,6,-1.05223600265178
"212",1490762841,2,5,5,5,5,22,7,10,11,8,10,46,6,4,1.12411354379732
"213",1490749263,2,4,3,1,3,13,5,8,7,5,6,31,10,5,-0.117326657113361
"214",1652755450,2,4,4,1,2,13,9,11,11,11,11,53,10,2,-0.740599554138976
"215",1491727076,1,1,1,1,3,7,10,7,6,6,8,37,10,7,1.47074229022351
"216",1667734774,3,4,4,2,3,16,5,6,7,7,7,32,10,4,-0.377120799205949
"217",1490604548,1,3,2,1,2,9,8,10,6,6,8,38,8,8,0.401970322076069
"218",1491564113,2,2,3,1,4,12,6,4,5,6,4,25,8,8,0.175230056547274
"219",1491654715,1,1,1,1,4,8,10,7,8,8,8,41,9,2,0.727580912300496
"220",1490579946,1,1,2,1,3,8,5,5,3,3,4,20,10,8,0.642684729316485
"221",1703276072,3,3,3,3,3,15,7,11,11,11,11,51,10,3,0.161255914835654
"222",1490678585,3,3,4,1,3,14,9,5,2,7,9,32,10,8,0.0384915671430424
"223",1490722012,1,2,2,1,3,9,11,11,8,6,9,45,10,5,0.642684729316485
"224",1490643116,3,1,2,2,1,9,11,10,10,10,11,52,1,8,1.47074229022351
"225",1490729250,2,1,2,1,1,7,2,2,2,1,1,8,5,8,0.415944463787689
"226",1490722823,1,2,3,1,4,11,7,8,8,6,7,36,9,7,0.727580912300496
"227",1343257496,1,3,2,2,3,11,7,9,5,6,5,32,9,7,0.642684729316485
"228",1490760487,2,1,1,2,4,10,8,9,7,8,11,43,2,8,1.36482795103773
"229",1717584618,4,4,3,3,2,16,9,5,10,6,5,35,1,4,-0.428963105626168
"230",1491516036,2,2,1,2,2,9,7,6,2,3,4,22,5,2,-0.377120799205949
"231",1491464974,3,2,3,3,4,15,6,7,6,6,5,30,4,6,-1.20805422690819
"232",1444141810,3,4,1,1,2,11,2,9,5,6,7,29,6,6,1.12411354379732
"233",1310678898,2,4,5,2,4,17,10,9,8,9,8,44,9,3,-1.20805422690819
"234",1490584403,2,1,2,2,2,9,7,7,7,7,7,35,5,5,0.642684729316485
"235",1518032041,2,2,1,1,1,7,9,10,3,3,3,28,6,7,-0.117326657113361
"236",1491553235,1,3,3,1,3,11,11,8,9,8,9,45,5,3,1.36482795103773
"237",1214828010,2,2,2,2,3,11,11,11,6,6,6,40,5,3,0.8833991365569
"238",1491531959,1,1,1,1,1,5,4,6,2,2,2,16,5,8,0.642684729316485
"239",1491515095,5,1,3,4,2,15,11,10,8,6,10,45,6,8,0.0384915671430424
"240",1490749688,1,3,2,2,1,9,11,3,2,2,2,20,5,8,1.47074229022351
"241",1490801061,2,3,3,2,3,13,8,8,8,8,8,40,8,6,1.47074229022351
"242",1204101803,2,2,5,1,4,14,3,3,3,2,2,13,10,7,-1.20805422690819
"243",1490751470,1,1,1,1,1,5,7,7,3,1,1,19,1,8,1.31492406596711
"244",1631526128,1,4,3,3,4,15,6,7,5,4,2,24,3,5,0.03338597400249
"245",1490588771,4,5,5,5,5,24,11,11,11,8,11,52,3,6,-1.20805422690819
"246",1491523178,4,4,1,1,3,13,6,6,6,6,6,30,1,2,-1.05223600265178
"247",1717405832,1,1,3,1,2,8,7,6,4,6,7,30,9,6,0.401970322076069
"248",1530061713,1,1,1,1,3,7,9,9,8,9,9,44,10,2,-1.05223600265178
"249",1491611344,1,1,3,4,5,14,5,8,8,6,9,36,4,4,-0.117326657113361
"250",1491519211,4,4,4,3,4,19,7,10,10,10,9,46,9,4,-0.740599554138976
"251",1490753808,3,2,1,1,4,11,9,4,7,6,7,33,3,7,0.161255914835654
"252",1491499300,4,3,3,3,3,16,6,8,8,6,6,34,7,4,0.0384915671430424
"253",1478186771,1,4,4,2,3,14,7,8,8,3,3,29,8,5,-1.20805422690819
"254",1491492032,1,2,2,1,2,8,5,5,4,5,4,23,7,6,-0.428963105626168
"255",1490655011,1,1,1,1,3,7,4,7,9,6,5,31,4,8,1.12411354379732
"256",1490677004,1,2,1,1,1,6,5,6,3,4,3,21,8,8,0.161255914835654
"257",1491482891,1,1,1,1,1,5,3,6,6,6,6,27,9,7,1.47074229022351
"258",1490725032,1,4,3,2,4,14,11,11,9,10,11,52,9,4,-1.20805422690819
"259",1260540920,2,3,3,2,3,13,6,6,6,6,6,30,8,8,0.161255914835654
"260",1490749635,2,2,2,2,3,11,5,5,5,6,6,27,8,6,0.161255914835654
"261",1491024711,4,2,3,2,4,15,8,8,3,4,3,26,7,6,0.175230056547274
"262",1491741817,2,2,1,1,1,7,6,7,7,1,1,22,7,4,-1.20805422690819
"263",1491523090,3,4,4,4,3,18,8,7,6,7,7,35,7,8,0.897373278268519
"264",1705042047,1,1,3,1,3,9,7,6,7,5,7,32,9,7,0.415944463787689
"265",1491717834,2,4,4,2,4,16,9,8,9,8,8,42,8,5,-1.20805422690819
"266",1073967191,1,1,1,1,2,6,11,11,7,7,7,43,9,3,0.8833991365569
"267",1473872379,1,1,2,1,3,8,9,8,9,6,7,39,7,3,-0.688757247718756
"268",1455025264,2,2,2,2,4,12,6,7,9,6,6,34,10,6,0.161255914835654
"269",1491513021,3,3,3,3,3,15,6,6,6,6,6,30,6,6,-1.20805422690819
"270",1490709682,2,4,4,3,4,17,5,5,5,3,6,24,5,5,0.00543769057925059
"271",1491593707,1,1,1,1,1,5,7,9,6,1,2,25,10,8,-0.428963105626168
"272",1491655494,1,1,2,1,4,9,8,7,7,4,2,28,5,5,0.727580912300496
"273",1237455223,1,1,4,1,4,11,8,5,7,7,7,34,3,6,0.642684729316485
"274",1490564585,3,1,4,1,5,14,9,10,10,9,10,48,1,8,0.401970322076069
"275",1613248286,3,3,3,3,3,15,7,7,7,7,7,35,9,6,1.36482795103773
"276",1491639543,1,1,1,1,1,5,8,8,6,6,6,34,7,4,-0.306198757933557
"277",1717479313,1,1,1,1,1,5,7,7,9,7,7,37,2,8,0.0384915671430424
"278",1491731432,1,1,4,1,1,8,11,10,7,3,5,36,2,7,1.12411354379732
"279",1491500643,3,1,3,1,5,13,9,7,5,9,8,38,2,6,-0.117326657113361
"280",1651057809,3,3,3,2,3,14,5,5,5,3,5,23,2,6,-0.117326657113361
"281",1627190404,2,2,3,2,3,12,3,7,7,9,7,33,7,5,0.104308015274882
"282",1491491244,2,4,5,2,4,17,9,10,8,7,6,40,7,3,-0.740599554138976
"283",1545547938,1,3,2,1,2,9,7,5,6,6,5,29,4,7,-0.117326657113361
"284",1692817747,1,4,3,1,3,12,5,5,8,6,3,27,8,6,0.345022422515297
"285",1491517248,1,3,2,3,4,13,2,5,5,1,1,14,8,8,0.246152097819666
"286",1491711331,1,4,3,1,4,13,6,10,8,2,6,32,10,4,-1.20805422690819
"287",1491383678,4,3,2,2,2,13,8,8,6,6,7,35,8,6,-0.117326657113361
"288",1491485477,1,2,2,1,4,10,4,5,5,4,5,23,10,8,0.00543769057925059
"289",1491748356,1,1,1,1,1,5,7,7,4,4,4,26,10,8,0.415944463787689
"290",1490754874,1,5,4,3,2,15,11,11,6,11,11,50,7,6,0.00543769057925059
"291",1529982244,1,1,1,1,1,5,11,9,8,7,9,44,7,2,-0.428963105626168
"292",1491073394,1,1,1,1,1,5,7,8,7,4,3,29,4,7,1.36482795103773
"293",1491487220,2,2,4,1,4,13,8,11,11,10,10,50,2,7,-0.117326657113361
"294",1490617939,4,4,3,4,3,18,3,3,3,3,3,15,1,4,0.161255914835654
"295",1655141614,4,4,4,4,4,20,9,4,7,7,8,35,5,6,0.00543769057925059
"296",1466400485,1,1,1,1,3,7,6,6,7,6,6,31,5,8,0.401970322076069
"297",1544701081,3,2,4,2,3,14,5,8,7,7,7,34,8,6,-1.20805422690819
"298",1491560542,1,1,1,1,1,5,6,8,6,5,2,27,10,3,0.175230056547274
"299",1717429571,4,3,2,2,5,16,8,8,6,6,7,35,10,5,-1.05223600265178
"300",1490619859,2,4,3,4,2,15,6,6,7,8,9,36,9,7,0.161255914835654
"301",1709052046,4,5,5,5,5,24,4,3,6,5,5,23,9,5,1.0032876174543
"302",1491754668,4,4,4,4,4,20,5,7,5,8,7,32,1,4,-1.05223600265178
"303",1570034822,2,2,2,2,3,11,7,10,2,3,2,24,2,8,-0.740599554138976
"304",1490567668,3,1,1,1,3,9,7,9,9,7,6,38,4,7,0.401970322076069
"305",1491600640,3,3,3,3,3,15,6,6,6,6,6,30,1,6,-0.0654843506931415
"306",1491483225,1,1,2,1,1,6,9,7,9,6,8,39,7,6,-0.428963105626168
"307",1490694754,1,4,3,3,4,15,11,11,7,9,9,47,9,6,-0.428963105626168
"308",1490710354,1,2,2,1,1,7,6,1,1,2,1,11,4,5,0.968295319540912
"309",1491728134,1,1,4,3,4,13,11,8,11,11,11,52,10,7,0.8833991365569
"310",1490710320,1,4,4,1,2,12,11,11,9,7,4,42,3,3,1.12411354379732
"311",1491773311,1,3,2,4,4,14,11,10,8,9,9,47,3,7,-1.05223600265178
"312",1491755877,1,4,1,1,3,10,9,10,10,1,1,31,9,8,0.0384915671430424
"313",1703581438,3,5,2,2,4,16,6,9,8,5,8,36,7,4,-0.428963105626168
"314",1652575595,1,2,2,1,4,10,11,7,6,6,6,36,6,2,0.8833991365569
"315",1491500283,1,3,3,1,3,11,8,9,7,4,2,30,1,7,0.8833991365569
"316",1260329070,1,1,1,1,4,8,11,10,10,9,10,50,2,7,-0.688757247718756
"317",1491628930,2,2,2,2,2,10,3,8,6,5,2,24,2,4,-1.05223600265178
"318",1490862150,2,2,2,2,2,10,6,6,6,6,6,30,2,2,1.47074229022351
"319",1491759243,3,4,3,5,4,19,7,8,7,9,10,41,8,5,0.161255914835654
"320",1490760191,4,5,4,4,5,22,11,10,10,10,11,52,9,2,0.0384915671430424
"321",1491525273,1,1,1,1,4,8,11,9,10,9,10,49,6,5,0.401970322076069
"322",1661210816,1,1,1,1,2,6,6,7,7,6,6,32,7,6,-1.20805422690819
"323",1490752744,1,1,2,1,2,7,3,5,6,2,2,18,3,6,0.415944463787689
"324",1573618660,2,2,4,1,2,11,6,7,6,7,7,33,3,6,0.642684729316485
"325",1445936721,4,3,3,3,3,16,6,9,9,7,8,39,8,7,-0.136406391965533
"326",1490610202,1,3,2,1,3,10,2,4,3,1,3,13,10,3,0.161255914835654
"327",1490732248,2,4,3,4,4,17,11,11,8,5,6,41,5,3,0.0384915671430424
"328",1588947019,1,3,3,3,3,13,9,9,10,7,8,43,3,4,1.36482795103773
"329",1490680056,3,3,3,3,3,15,10,11,6,6,2,35,3,7,1.12411354379732
"330",1607946359,1,1,1,1,1,5,7,8,3,3,2,23,1,6,1.47074229022351
"331",1610041795,1,1,1,1,1,5,6,6,7,7,7,33,2,6,0.8833991365569
"332",1491778584,3,3,3,3,3,15,6,6,6,6,6,30,5,7,-1.05223600265178
"333",1490565246,2,1,1,1,2,7,5,3,5,5,4,22,10,6,0.161255914835654
"334",1491752555,3,3,3,3,3,15,7,8,6,8,7,36,7,2,-1.20805422690819
"335",1491566942,3,3,3,3,3,15,6,6,6,6,6,30,1,7,0.486866505060081
"336",1491123249,2,4,1,1,3,11,4,5,8,4,4,25,1,7,0.0384915671430424
"337",1491737626,1,1,3,1,3,9,2,6,3,1,1,13,1,4,-1.20805422690819
"338",1148956532,4,5,5,5,5,24,11,11,8,11,11,52,4,2,-1.20805422690819
"339",1690617445,3,3,4,2,2,14,11,10,8,10,11,50,5,4,-0.117326657113361
"340",1627411632,2,3,2,1,4,12,9,8,7,7,7,38,8,4,0.401970322076069
"341",1491509341,4,2,3,2,3,14,7,5,6,6,8,32,1,3,-0.377120799205949
"342",1490871145,1,1,1,1,1,5,3,7,7,4,4,25,4,4,1.47074229022351
"343",1490670906,3,3,3,3,3,15,7,6,6,6,6,31,6,6,1.47074229022351
"344",1601692582,3,3,3,3,3,15,6,6,6,6,6,30,5,2,-0.306198757933557
"345",1491451684,1,2,2,1,2,8,3,3,2,2,2,12,3,5,1.47074229022351
"346",1675508212,1,1,1,1,1,5,7,7,8,4,4,30,7,8,1.12411354379732
"347",1490681588,2,4,2,1,2,11,7,7,7,5,6,32,6,2,1.36482795103773
"348",1491710639,2,3,4,1,2,12,7,9,7,6,8,37,8,4,1.12411354379732
"349",1491557190,2,2,2,2,2,10,7,7,8,6,8,36,6,5,0.401970322076069
"350",1491775781,2,2,2,2,2,10,6,8,6,6,6,32,10,7,0.00543769057925059
"351",1491716458,1,5,5,3,3,17,9,7,3,4,7,30,6,8,1.47074229022351
"352",1676400616,1,1,1,1,1,5,9,10,6,5,6,36,5,6,1.12411354379732
"353",1491483660,3,3,5,4,5,20,11,11,11,11,11,55,10,6,-1.20805422690819
"354",1490625475,2,3,3,1,1,10,8,8,9,6,8,39,6,7,0.8833991365569
"355",1490591859,1,1,1,1,1,5,11,8,9,3,7,38,8,6,0.8833991365569
"356",1490862972,3,3,1,1,1,9,8,10,10,10,10,48,8,5,-0.428963105626168
"357",1530400555,3,3,3,1,3,13,6,5,6,6,6,29,4,5,-1.05223600265178
"358",1520408860,1,2,3,1,1,8,10,9,8,8,8,43,1,8,-1.20805422690819
"359",1491493531,2,2,2,2,2,10,8,8,7,6,8,37,10,8,0.401970322076069
"360",1491773933,1,1,1,1,1,5,7,11,3,6,8,35,3,6,1.47074229022351
"361",1490583531,2,2,3,1,3,11,6,7,2,2,2,19,3,6,-1.20805422690819
"362",1651046532,2,1,4,2,5,14,10,11,11,7,11,50,3,5,1.36482795103773
"363",1490727899,2,3,2,2,1,10,7,8,7,6,7,35,9,6,0.161255914835654
"364",1491479911,2,2,1,1,3,9,11,10,10,4,4,39,10,4,0.175230056547274
"365",1491764878,3,3,3,3,3,15,6,6,6,6,6,30,3,6,-1.20805422690819
"366",1491685008,1,3,4,1,3,12,6,7,5,4,8,30,3,7,-1.20805422690819
"367",1491633330,3,5,4,4,4,20,9,10,8,4,2,33,3,7,0.161255914835654
"368",1478255691,1,2,2,2,2,9,4,7,3,3,3,20,1,3,0.8833991365569
"369",1360443230,2,4,4,2,3,15,6,8,7,4,5,30,5,8,-1.20805422690819
"370",1491782261,1,2,1,1,2,7,6,5,7,6,5,29,1,6,0.00543769057925059
"371",1491780116,1,1,3,1,1,7,7,7,5,3,2,24,3,8,0.0384915671430424
"372",1697432502,4,2,3,3,1,13,8,9,2,5,7,31,1,4,0.968295319540912
"373",1490592234,1,1,2,1,3,8,9,6,8,6,6,35,5,6,-0.117326657113361
"374",1490588912,1,1,3,1,3,9,11,11,11,11,11,55,9,4,0.0384915671430424
"375",1491715751,2,4,4,2,4,16,5,8,5,6,6,30,1,7,-1.20805422690819
"376",1491751182,1,2,3,3,4,13,7,7,7,6,6,33,2,6,0.401970322076069
"377",1490761930,1,3,3,2,3,12,3,3,4,6,7,23,9,6,1.47074229022351
"378",1490753409,1,1,2,1,3,8,11,11,11,11,11,55,5,8,0.0384915671430424
"379",1333488936,1,1,1,1,1,5,8,10,6,6,6,36,1,4,1.12411354379732
"380",1686603154,1,3,1,1,2,8,11,7,8,7,8,41,9,6,-0.117326657113361
"381",1490717059,1,2,2,1,1,7,7,7,4,7,7,32,3,7,0.00543769057925059
"382",1491685273,4,5,3,3,5,20,9,11,9,6,8,43,3,5,0.0384915671430424
"383",1491519928,3,3,3,3,3,15,6,6,6,6,6,30,6,4,-1.20805422690819
"384",1491514917,1,2,4,1,4,12,5,9,8,7,8,37,8,8,-1.20805422690819
"385",1490579197,3,3,3,3,3,15,6,6,6,6,6,30,10,4,-0.617835206446364
"386",1491772241,1,1,1,1,1,5,7,6,4,5,6,28,9,8,1.47074229022351
"387",1491748296,1,1,1,1,1,5,7,8,8,5,3,31,8,8,-0.740599554138976
"388",1490565375,1,3,1,1,4,10,8,10,9,6,6,39,7,6,0.897373278268519
"389",1331398901,1,1,1,1,4,8,9,9,9,6,6,39,8,2,-0.117326657113361
"390",1520044552,1,1,1,1,1,5,4,6,1,2,2,15,3,8,0.246152097819666
"391",1490584419,3,3,3,2,3,14,7,7,7,6,5,32,7,4,0.161255914835654
"392",1316242757,3,1,1,1,1,7,9,8,7,6,4,34,9,5,0.401970322076069
"393",1529974622,1,1,4,1,2,9,8,10,5,3,6,32,1,8,0.0384915671430424
"394",1491511988,1,3,5,3,3,15,11,11,11,11,11,55,3,8,-0.603861064734744
"395",1594615525,1,1,1,1,3,7,7,7,6,2,2,24,8,8,1.47074229022351
"396",1328554753,2,4,3,2,4,15,6,6,6,6,6,30,8,4,-1.20805422690819
"397",1404184007,1,1,1,1,1,5,3,3,1,1,1,9,8,5,1.47074229022351
"398",1490595963,1,1,1,1,3,7,6,6,6,6,6,30,1,6,-0.117326657113361
"399",1490631925,2,3,4,2,3,14,8,9,8,7,4,36,8,4,-1.05223600265178
"400",1490619873,1,1,1,1,1,5,8,6,5,2,2,23,8,8,0.8833991365569
"401",1520435570,3,3,3,3,3,15,9,10,8,7,9,43,8,8,-1.20805422690819
"402",1491510554,1,4,2,1,3,11,6,7,8,8,6,35,8,5,0.00543769057925059
"403",1491580006,1,1,1,1,1,5,8,7,8,2,2,27,7,8,0.401970322076069
"404",1490578223,1,4,3,1,2,11,8,7,8,6,6,35,1,7,0.727580912300496
"405",1491480421,2,2,2,2,2,10,6,5,7,6,7,31,9,6,0.00543769057925059
"406",1716207922,3,3,3,3,3,15,6,6,6,6,6,30,5,4,0.0384915671430424
"407",1490858435,3,3,3,3,3,15,8,6,5,7,8,34,5,4,-0.117326657113361
"408",1490713605,1,1,2,1,2,7,3,4,4,3,2,16,3,7,1.12411354379732
"409",1340736076,1,4,3,2,2,12,9,7,6,5,7,34,1,3,0.401970322076069
"410",1491087775,2,3,4,4,5,18,9,10,8,7,10,44,2,3,0.161255914835654
"411",1517126250,4,3,3,3,3,16,4,4,2,2,2,14,2,6,0.8833991365569
"412",1490732345,2,2,3,2,2,11,6,7,8,5,6,32,3,7,0.0384915671430424
"413",1490759186,2,3,2,1,2,10,10,8,7,2,2,29,3,6,0.00543769057925059
"414",1490756027,1,2,3,1,4,11,6,9,8,6,7,36,4,6,1.36482795103773
"415",1260355792,1,1,1,1,1,5,9,10,10,8,10,47,4,8,0.8833991365569
"416",1490750513,1,1,1,1,2,6,10,10,4,3,6,33,6,7,0.0384915671430424
"417",1491758590,3,3,3,3,3,15,11,11,11,11,11,55,10,4,0.0384915671430424
"418",1490755169,1,3,4,3,5,16,11,11,11,11,11,55,5,2,0.0384915671430424
"419",1706492105,3,3,3,3,3,15,6,6,6,6,6,30,5,5,-1.20805422690819
"420",1491775376,1,2,2,2,3,10,9,10,7,6,7,39,8,8,-0.117326657113361
"421",1490590041,2,2,1,1,1,7,8,8,6,6,6,34,8,8,1.47074229022351
"422",1490580111,3,3,3,3,3,15,3,6,1,1,1,12,6,6,1.47074229022351
"423",1490585126,2,2,2,2,2,10,3,7,3,1,5,19,9,7,0.0384915671430424
"424",1491523936,2,1,1,1,1,6,9,9,8,5,4,35,8,8,0.8833991365569
"425",1491488284,3,5,5,5,5,23,6,6,6,6,6,30,1,4,-1.20805422690819
"426",1490749115,3,3,3,3,4,16,7,6,7,8,7,35,3,5,-0.740599554138976
"427",1490726030,4,3,3,1,2,13,8,9,8,6,7,38,9,5,0.727580912300496
"428",1703076795,4,5,5,5,4,23,11,11,11,6,7,46,9,2,1.12411354379732
"429",1490578754,1,1,1,1,2,6,8,8,6,7,9,38,8,8,-0.428963105626168
"430",1490573073,1,1,1,1,1,5,9,9,6,4,6,34,6,8,1.36482795103773
"431",1490723267,1,1,1,1,2,6,8,9,8,5,6,36,8,6,1.47074229022351
"432",1491222060,3,2,3,3,3,14,6,6,6,6,6,30,6,2,0.0384915671430424
"433",1311077750,3,3,4,2,3,15,6,11,9,4,6,36,10,6,0.104308015274882
"434",1491528257,5,1,1,1,1,9,11,11,6,11,11,50,9,8,0.161255914835654
"435",1490752908,1,1,1,1,1,5,7,6,6,5,7,31,9,8,1.47074229022351
"436",1491509918,1,4,3,1,3,12,11,6,1,3,1,22,10,4,0.8833991365569
"437",1490564203,4,4,4,4,4,20,11,11,11,9,9,51,9,2,0.161255914835654
"438",1611387447,5,5,3,3,4,20,9,9,11,8,8,45,8,6,-0.428963105626168
"439",1491221765,4,4,4,4,4,20,9,9,9,9,9,45,1,6,-1.20805422690819
"440",1490639128,3,3,5,3,3,17,6,6,6,6,6,30,9,3,0.642684729316485
"441",1490755960,1,1,1,1,1,5,8,8,8,7,6,37,7,3,0.0384915671430424
"442",1611647846,1,2,2,2,2,9,8,7,5,6,10,36,2,6,0.401970322076069
"443",1490710585,4,4,3,4,3,18,6,6,6,6,6,30,8,4,-1.20805422690819
"444",1490889302,1,3,4,1,4,13,11,11,9,10,11,52,10,8,0.175230056547274
"445",1490721777,1,2,3,1,3,10,8,7,7,6,6,34,9,6,1.47074229022351
"446",1491529687,3,4,3,3,3,16,8,8,6,6,8,36,7,6,0.03338597400249
"447",1491609188,1,2,3,1,3,10,11,7,6,4,6,34,9,6,-0.740599554138976
"448",1490760682,4,4,4,1,1,14,11,11,9,1,1,33,7,4,-0.448042840478341
"449",1490758244,1,5,2,2,4,14,11,11,11,11,11,55,10,2,-1.20805422690819
"450",1490717186,2,3,3,1,3,12,8,9,8,5,4,34,8,6,0.161255914835654
"451",1524327800,3,3,3,3,3,15,6,6,6,6,6,30,6,8,0.656658871028104
"452",1490757042,1,3,3,1,5,13,4,10,2,1,1,18,9,4,-1.20805422690819
"453",1491717929,4,1,1,1,1,8,6,8,2,2,8,26,10,8,-1.20805422690819
"454",1491400976,1,1,1,1,1,5,7,3,7,2,2,21,5,8,0.175230056547274
"455",1520435060,3,4,5,4,5,21,8,6,3,2,6,25,8,7,-0.929471654959171
"456",1233918024,4,1,1,1,3,10,8,10,6,7,7,38,1,4,-0.428963105626168
"457",1491549941,1,1,3,1,3,9,10,10,11,10,10,51,2,6,0.345022422515297
"458",1491493895,4,1,1,1,2,9,6,4,6,4,6,26,10,5,-0.740599554138976
"459",1491766134,1,3,3,2,2,11,11,7,10,5,8,41,10,6,0.0384915671430424
"460",1491776938,1,1,1,1,1,5,11,11,11,7,8,48,10,8,-1.20805422690819
"461",1491637412,3,3,2,1,2,11,9,8,7,6,7,37,7,4,0.00543769057925059
"462",1696960474,3,4,3,3,3,16,6,6,6,6,6,30,9,5,0.642684729316485
"463",1490753748,2,3,3,3,2,13,7,8,8,7,8,38,10,5,0.0384915671430424
"464",1491488632,5,5,5,5,5,25,11,6,6,6,6,35,1,8,-0.448042840478341
"465",1490750027,3,5,5,4,5,22,8,8,6,7,10,39,9,8,0.727580912300496
"466",1565022785,1,2,2,2,2,9,1,2,3,3,3,12,1,2,-1.20805422690819
"467",1491512388,1,1,1,1,1,5,7,9,9,8,7,40,8,8,0.401970322076069
"468",1490755640,1,1,1,1,3,7,11,10,11,6,11,49,7,8,0.0384915671430424
"469",1490714132,2,3,2,2,1,10,9,8,9,9,10,45,7,2,0.00543769057925059
"470",1490581679,4,3,2,3,3,15,3,4,4,3,4,18,10,6,-0.0654843506931415
"471",1490648509,3,4,3,3,3,16,9,8,9,9,8,43,2,6,1.47074229022351
"472",1672994097,4,4,5,5,5,23,11,11,11,11,11,55,4,2,-0.428963105626168
"473",1693660832,3,3,3,2,5,16,9,9,6,6,9,39,10,4,-0.603861064734744
"474",1491515322,1,1,1,1,2,6,8,8,6,7,8,37,7,6,0.8833991365569
"475",1491510380,1,5,5,5,5,21,11,11,11,11,11,55,7,2,-1.20805422690819
"476",1490627544,1,1,1,1,1,5,9,11,9,9,9,47,6,6,1.12411354379732
"477",1491781830,2,2,2,1,4,11,9,9,6,9,9,42,8,6,1.47074229022351
"478",1696622811,4,3,3,3,3,16,8,8,8,8,8,40,8,2,1.47074229022351
"479",1491741888,1,1,2,1,1,6,11,7,7,9,8,42,6,6,1.47074229022351
"480",1709338170,3,4,3,2,3,15,11,11,11,11,11,55,7,6,-1.05223600265178
"481",1490664454,1,1,1,1,2,6,6,9,3,2,1,21,9,6,-1.20805422690819
"482",1491489121,1,1,1,1,3,7,6,7,5,5,4,27,5,6,-1.20805422690819
"483",1491070361,1,1,2,1,4,9,11,10,3,4,9,37,2,6,-0.306198757933557
"484",1548988689,1,1,1,1,3,7,10,9,9,8,8,44,2,6,-0.428963105626168
"485",1399559394,2,1,1,1,1,6,11,11,11,11,11,55,9,8,0.0384915671430424
"486",1491482988,2,2,3,2,4,13,9,9,6,8,8,40,6,2,-0.740599554138976
"487",1491749168,2,4,2,1,3,12,7,10,9,6,8,40,6,5,0.246152097819666
"488",1697018347,3,4,3,2,2,14,8,9,7,7,7,38,5,5,-0.740599554138976
"489",1491711702,1,1,1,1,3,7,7,7,8,6,8,36,5,6,0.642684729316485
"490",1292718110,4,4,3,4,4,19,6,5,7,4,5,27,6,8,-0.617835206446364
"491",1490587420,1,3,1,1,3,9,8,9,9,7,7,40,6,8,1.47074229022351
"492",1490614298,2,3,3,2,3,13,11,11,9,11,11,53,6,7,0.401970322076069
"493",1490949817,2,4,3,3,3,15,7,9,9,8,8,41,10,3,1.47074229022351
"494",1491779465,1,1,1,1,2,6,8,8,7,7,6,36,5,4,-0.136406391965533
"495",1490613526,4,2,3,4,2,15,6,3,6,8,3,26,6,6,1.47074229022351
"496",1421518615,4,4,4,4,4,20,8,8,8,8,8,40,10,2,-1.20805422690819
"497",1491482139,4,5,4,1,4,18,8,11,9,5,5,38,10,5,1.47074229022351
"498",1491517692,1,2,1,1,2,7,6,6,7,8,8,35,7,8,0.401970322076069
"499",1491777471,1,1,1,1,5,9,7,8,6,6,6,33,10,2,0.8833991365569
"500",1491476455,3,3,4,5,3,18,6,8,5,3,6,28,8,7,0.0384915671430424
"501",1491594883,1,1,2,1,1,6,11,7,6,1,2,27,8,8,1.47074229022351
"502",1491564911,5,5,5,5,5,25,8,8,8,8,8,40,6,6,-1.20805422690819
"503",1490598747,4,3,1,1,2,11,9,9,8,8,8,42,10,6,0.175230056547274
"504",1491775444,1,2,4,2,2,11,8,11,9,9,11,48,5,7,1.36482795103773
"505",1491032060,4,3,3,4,3,17,6,8,6,7,9,36,6,3,0.175230056547274
"506",1647570645,1,1,3,1,1,7,3,6,4,4,4,21,9,8,0.401970322076069
"507",1491772987,4,2,2,2,3,13,9,8,10,7,7,41,1,5,-1.20805422690819
"508",1490601829,2,4,5,2,4,17,8,4,9,3,2,26,1,6,-0.428963105626168
"509",1490725159,3,3,3,1,3,13,8,8,7,6,6,35,3,4,0.0384915671430424
"510",1619463728,5,5,5,5,3,23,11,11,11,11,11,55,3,3,-0.844575471975159
"511",1491767678,3,3,3,2,3,14,5,7,7,6,8,33,6,6,0.401970322076069
"512",1490862222,4,3,4,1,2,14,4,5,8,9,9,35,5,2,0.0384915671430424
"513",1491743698,2,3,4,1,1,11,5,3,4,2,5,19,7,8,-1.20805422690819
"514",1491747146,1,3,2,1,3,10,6,6,2,1,2,17,5,4,-1.20805422690819
"515",1403977022,1,3,2,1,1,8,11,7,11,11,11,51,6,6,-0.740599554138976
"516",1491514778,4,1,2,1,2,10,9,8,7,6,7,37,10,6,0.401970322076069
"517",1491763333,1,1,1,1,4,8,9,11,9,7,10,46,5,8,0.161255914835654
"518",1490726285,3,4,3,2,4,16,10,10,6,6,9,41,3,6,0.161255914835654
"519",1369130530,4,4,3,3,2,16,7,8,8,6,8,37,3,6,-0.428963105626168
"520",1277560487,5,4,3,2,3,17,11,11,11,11,11,55,10,6,-1.05223600265178
"521",1490710408,4,4,4,4,4,20,11,11,11,11,11,55,1,5,-0.0654843506931415
"522",1491775459,1,2,1,1,1,6,11,7,6,5,8,37,4,6,-1.20805422690819
"523",1297703325,3,3,3,3,3,15,9,9,9,8,7,42,1,6,-0.117326657113361
"524",1491506895,1,1,1,1,1,5,11,9,7,10,11,48,8,8,0.00543769057925059
"525",1490597395,1,2,3,1,3,10,6,6,6,6,6,30,2,6,-1.05223600265178
"526",1490717827,1,4,2,1,4,12,8,7,7,3,6,31,1,4,0.161255914835654
"527",1491535108,2,4,2,1,4,13,9,8,9,6,8,40,1,8,-0.0654843506931415
"528",1400501281,1,3,4,2,4,14,8,6,8,6,7,35,1,7,0.0384915671430424
"529",1491641499,1,1,1,1,1,5,11,11,8,8,8,46,1,8,1.12411354379732
"530",1491517761,2,2,2,2,2,10,8,6,7,9,9,39,7,8,0.968295319540912
"531",1490684257,1,3,3,1,3,11,7,6,6,6,7,32,7,6,-0.428963105626168
"532",1490596293,1,4,4,3,4,16,9,11,10,9,10,49,5,6,-1.20805422690819
"533",1490924541,3,4,3,3,2,15,8,7,8,6,6,35,6,7,0.401970322076069
"534",1491753033,2,2,3,3,4,14,3,3,3,4,5,18,5,3,0.00543769057925059
"535",1490760283,1,5,4,5,5,20,9,9,10,3,6,37,5,7,0.175230056547274
"536",1490732033,5,3,4,1,4,17,3,3,2,6,2,16,5,6,-1.20805422690819
"537",1491549631,3,3,3,3,3,15,6,6,6,6,6,30,3,6,1.47074229022351
"538",1490721935,1,3,1,1,4,10,11,7,7,6,7,38,7,2,-0.428963105626168
"539",1520782290,1,4,2,3,2,12,9,10,5,6,8,38,7,2,-0.428963105626168
"540",1491488721,1,1,1,1,1,5,7,9,11,7,8,42,7,8,0.0384915671430424
"541",1491665541,1,1,1,1,3,7,7,7,4,1,1,20,5,7,0.8833991365569
"542",1491533659,1,2,1,1,2,7,2,7,1,1,1,12,1,8,0.161255914835654
"543",1491484442,1,3,4,2,2,12,9,8,9,8,9,43,5,4,0.246152097819666
"544",1680517250,3,2,2,2,2,11,8,8,5,6,6,33,6,6,-0.740599554138976
"545",1490749485,1,1,1,1,1,5,8,8,9,9,10,44,5,8,1.47074229022351
"546",1675591648,1,1,1,1,1,5,6,9,8,4,4,31,2,7,0.0384915671430424
"547",1490808582,3,3,3,3,3,15,6,6,6,6,6,30,10,4,-1.20805422690819
"548",1318069468,2,3,3,2,3,13,6,6,6,6,6,30,8,6,0.8833991365569
"549",1491777460,1,1,1,1,1,5,11,10,6,10,8,45,8,8,-1.20805422690819
"550",1626149530,1,4,4,1,3,13,8,8,7,6,4,33,9,8,-1.20805422690819
"551",1491359647,3,3,3,3,3,15,6,6,6,6,6,30,7,6,0.897373278268519
"552",1491738900,1,1,1,1,3,7,6,6,1,1,1,15,3,4,0.642684729316485
"553",1491776228,3,4,3,2,2,14,8,9,7,9,9,42,1,8,0.0384915671430424
"554",1490673581,1,2,2,2,2,9,4,5,8,3,5,25,8,8,0.8833991365569
"555",1491749191,4,4,2,2,3,15,7,7,7,7,7,35,5,6,-1.20805422690819
"556",1491638191,1,1,1,1,1,5,7,10,8,3,6,34,2,5,1.12411354379732
"557",1490573588,5,1,1,1,1,9,6,8,7,6,6,33,10,7,0.161255914835654
"558",1490647481,3,4,3,3,3,16,6,6,5,5,7,29,7,5,0.401970322076069
"559",1491772362,4,3,4,2,4,17,8,8,5,5,8,34,2,5,1.47074229022351
"560",1491630037,1,1,4,1,1,8,5,8,2,2,2,19,1,5,0.401970322076069
"561",1491787262,3,4,2,1,1,11,6,7,8,7,2,30,2,8,0.161255914835654
"562",1490756994,3,4,4,3,5,19,11,11,6,10,10,48,3,7,-1.20805422690819
"563",1694824097,1,3,2,1,1,8,6,4,5,1,6,22,4,7,0.0384915671430424
"564",1410317727,4,2,1,1,1,9,9,7,6,3,3,28,2,4,0.642684729316485
"565",1491519859,1,3,2,1,5,12,7,8,9,8,9,41,2,6,0.161255914835654
"566",1675640026,5,5,5,5,5,25,9,11,1,6,11,38,2,2,0.161255914835654
"567",1490721002,4,3,2,1,2,12,10,9,10,10,11,50,1,7,-1.08528987921557
"568",1392850814,3,4,3,2,3,15,3,9,4,4,6,26,1,7,0.246152097819666
"569",1383067877,2,2,1,1,2,8,6,8,7,7,5,33,1,6,1.12411354379732
"570",1490757630,1,1,1,1,2,6,6,6,6,6,6,30,5,7,-0.428963105626168
"571",1578306259,4,4,5,3,4,20,11,11,2,6,11,41,1,7,-0.740599554138976
"572",1490727077,1,1,1,1,1,5,9,7,10,9,9,44,9,8,0.642684729316485
"573",1490575751,2,3,4,1,3,13,6,6,5,5,6,28,8,4,0.642684729316485
"574",1342740841,3,5,4,5,5,22,10,10,11,8,10,49,1,2,0.727580912300496
"575",1491774426,1,1,1,1,1,5,11,7,6,6,7,37,1,4,1.47074229022351
"576",1491652993,2,2,2,1,2,9,6,9,4,3,3,25,1,8,-0.117326657113361
"577",1490709987,4,4,3,3,3,17,7,6,6,7,7,33,8,6,0.03338597400249
"578",1491707394,1,1,2,1,1,6,4,7,7,4,4,26,4,5,0.486866505060081
"579",1491484232,1,3,2,1,1,8,9,11,9,9,9,47,9,3,0.0384915671430424
"580",1491503141,1,4,4,3,5,17,9,11,7,7,6,40,1,4,-0.117326657113361
"581",1318027238,1,1,1,1,2,6,10,8,6,6,7,37,1,8,-0.117326657113361
"582",1491543882,5,3,3,3,3,17,6,7,7,6,11,37,1,8,0.401970322076069
"583",1260334210,1,1,1,1,1,5,7,6,5,5,4,27,1,6,0.642684729316485
"584",1490709047,5,5,5,5,5,25,11,11,11,11,11,55,4,8,-1.20805422690819
"585",1457604992,2,2,3,3,3,13,9,8,9,9,8,43,4,8,0.161255914835654
"586",1491521601,2,4,4,1,3,14,11,10,10,4,6,41,4,7,0.415944463787689
"587",1490565056,1,1,1,1,2,6,10,6,5,6,7,34,6,7,1.36482795103773
"588",1594739788,3,5,4,3,3,18,11,11,11,11,11,55,4,2,-1.20805422690819
"589",1491726013,1,2,3,1,1,8,11,3,2,6,6,28,5,7,-0.428963105626168
"590",1491575686,3,4,4,3,2,16,5,6,5,7,5,28,6,6,0.727580912300496
"591",1491518983,4,4,3,2,3,16,7,9,6,6,6,34,8,7,0.161255914835654
"592",1490726651,1,1,1,1,1,5,9,8,9,4,4,34,3,8,1.47074229022351
"593",1107948504,1,1,1,1,3,7,10,9,8,8,9,44,10,8,1.36482795103773
"594",1191567058,1,3,3,1,2,10,8,9,10,9,9,45,5,2,1.47074229022351
"595",1490720646,3,4,4,3,4,18,7,7,7,7,9,37,3,4,-1.20805422690819
"596",1491481098,4,4,4,4,4,20,6,11,11,7,6,41,8,2,0.486866505060081
"597",1490798534,4,3,2,1,4,14,6,6,6,6,6,30,1,4,-1.20805422690819
"598",1604367974,2,2,2,2,2,10,6,11,11,6,6,40,10,2,-0.740599554138976
"599",1490627583,1,1,2,1,1,6,11,11,11,11,11,55,8,2,-0.377120799205949
"600",1491507796,3,2,3,3,2,13,3,6,7,6,3,25,8,6,0.897373278268519
"601",1690529740,2,3,1,1,1,8,7,7,6,5,5,30,1,8,1.47074229022351
"602",1491340026,1,1,2,1,1,6,9,9,6,8,8,40,1,7,0.401970322076069
"603",1490571963,3,3,2,3,3,14,11,11,7,6,11,46,2,5,-1.20805422690819
"604",1490596942,3,4,3,3,3,16,7,10,6,7,7,37,4,7,-0.617835206446364
"605",1684688886,2,2,2,2,2,10,8,6,8,8,6,36,10,5,0.246152097819666
"606",1642959041,3,4,4,3,3,17,7,7,7,7,7,35,3,6,-1.20805422690819
"607",1520468197,1,1,1,1,1,5,6,4,6,4,3,23,7,6,0.8833991365569
"608",1490603503,3,2,3,1,3,12,7,8,4,5,5,29,4,6,-1.20805422690819
"609",1491765919,2,5,4,1,5,17,6,6,6,6,5,29,1,3,0.161255914835654
"610",1491632919,1,1,1,1,1,5,11,10,9,10,9,49,1,2,-0.117326657113361
"611",1491541728,1,3,3,1,2,10,8,10,7,5,4,34,3,6,0.246152097819666
"612",1490750506,1,1,1,1,1,5,4,10,6,6,5,31,1,6,1.47074229022351
"613",1490682235,2,1,1,1,1,6,9,9,6,4,6,34,1,5,1.47074229022351
"614",1490565561,2,2,2,1,3,10,7,9,5,5,7,33,1,4,0.401970322076069
"615",1491212831,1,4,4,2,2,13,11,11,11,11,11,55,1,8,-1.20805422690819
"616",1490572257,4,4,3,4,3,18,6,8,10,6,7,37,1,8,0.401970322076069
"617",1491209623,4,2,3,3,4,16,8,7,9,9,10,43,1,4,-1.20805422690819
"618",1545521864,1,4,3,1,4,13,11,9,5,1,1,27,1,4,-0.740599554138976
"619",1491718405,1,2,4,1,2,10,3,3,5,1,3,15,1,7,1.36482795103773
"620",1490629415,4,3,2,2,2,13,9,4,6,2,2,23,1,6,-0.117326657113361
"621",1618169255,1,4,3,2,4,14,9,9,6,6,7,37,1,3,0.161255914835654
"622",1491750139,1,1,2,1,1,6,3,5,2,2,3,15,2,8,1.47074229022351
"623",1539697619,2,2,3,3,3,13,7,8,9,10,11,45,9,4,0.486866505060081
"624",1529982634,4,4,4,4,5,21,8,3,10,9,9,39,2,7,0.246152097819666
"625",1490563224,1,4,2,2,5,14,9,9,6,4,4,32,9,6,0.0384915671430424
"626",1491724680,1,2,4,1,5,13,7,9,6,6,6,34,8,2,0.401970322076069
"627",1491529340,1,3,3,3,4,14,10,10,8,6,6,40,1,8,1.47074229022351
"628",1491519258,4,2,3,1,1,11,2,4,7,7,2,22,9,8,0.727580912300496
"629",1490729930,1,2,3,1,3,10,11,11,10,10,11,53,7,4,0.8833991365569
"630",1491567312,3,3,3,3,3,15,8,8,6,7,7,36,1,7,-0.117326657113361
"631",1701056403,1,1,1,1,1,5,2,2,7,1,1,13,4,5,1.47074229022351
"632",1491558932,3,3,3,3,3,15,8,6,6,8,7,35,4,4,-0.428963105626168
"633",1491497551,2,4,4,1,4,15,8,8,4,5,6,31,1,8,-1.05223600265178
"634",1490594347,4,4,4,4,4,20,7,8,8,8,8,39,3,4,-0.117326657113361
"635",1491530165,3,4,3,3,4,17,6,6,9,6,9,36,3,6,-1.20805422690819
"636",1580410536,1,1,1,1,2,6,7,7,4,5,7,30,2,8,0.8833991365569
"637",1400661414,1,4,2,1,3,11,8,9,4,2,3,26,1,3,1.47074229022351
"638",1384869554,4,4,4,4,4,20,6,6,6,6,6,30,3,5,0.401970322076069
"639",1531769337,3,3,2,2,2,12,5,4,4,3,9,25,9,8,0.00543769057925059
"640",1490598869,1,1,1,1,1,5,9,9,10,8,9,45,7,6,0.0384915671430424
"641",1558617322,3,3,3,3,3,15,5,9,9,9,9,41,3,8,1.47074229022351
"642",1491008639,4,4,3,3,3,17,9,8,7,8,8,40,2,6,-0.306198757933557
"643",1491493584,2,2,4,3,4,15,7,7,7,6,6,33,1,4,-0.740599554138976
"644",1490667847,1,3,4,4,4,16,10,11,7,8,11,47,4,4,0.0384915671430424
"645",1491749285,5,5,5,5,5,25,9,10,11,6,7,43,5,4,-1.20805422690819
"646",1319620843,1,1,1,1,1,5,11,9,2,6,7,35,7,8,0.00543769057925059
"647",1490595887,1,1,1,1,1,5,7,7,4,7,5,30,2,6,0.161255914835654
"648",1490685376,1,1,1,1,1,5,8,9,8,8,7,40,6,7,-0.929471654959171
"649",1491517909,3,5,4,4,5,21,9,4,7,6,6,32,5,4,-1.20805422690819
"650",1490639765,3,3,3,2,3,14,11,11,7,6,2,37,3,8,-1.20805422690819
"651",1491520465,3,4,4,3,2,16,11,11,8,6,10,46,10,4,0.8833991365569
"652",1490603059,3,4,4,1,1,13,11,11,10,9,11,52,10,6,1.36482795103773
"653",1696381422,1,1,1,1,1,5,6,6,6,6,6,30,3,2,0.642684729316485
"654",1491535706,1,3,2,1,2,9,6,11,2,2,2,23,5,2,-0.428963105626168
"655",1077686493,3,3,3,3,3,15,6,6,6,6,6,30,1,6,-1.20805422690819
"656",1491530440,1,4,5,3,4,17,8,11,7,6,6,38,1,4,-0.929471654959171
"657",1490862170,3,5,4,4,3,19,11,8,8,7,8,42,1,5,-0.428963105626168
"658",1490805636,1,1,3,1,3,9,2,2,1,2,1,8,3,6,0.401970322076069
"659",1297602421,1,4,5,1,4,15,11,11,11,11,11,55,1,5,-1.20805422690819
"660",1491486990,1,1,1,1,4,8,10,10,6,7,10,43,10,2,0.8833991365569
"661",1650765886,1,1,1,1,1,5,10,9,7,3,5,34,7,4,0.161255914835654
"662",1491522938,1,1,2,1,1,6,7,7,6,6,6,32,5,2,0.175230056547274
"663",1490758504,2,4,4,4,4,18,7,9,6,6,6,34,2,4,1.20900972678133
"664",1674798498,4,4,4,4,4,20,6,9,3,3,6,27,2,6,0.175230056547274
"665",1404038723,4,1,1,1,2,9,9,5,10,10,11,45,2,8,0.246152097819666
"666",1490626179,1,3,4,3,5,16,7,7,11,8,8,41,1,8,0.401970322076069
"667",1490757175,1,3,2,1,3,10,8,9,9,6,8,40,5,6,-0.117326657113361
"668",1491528303,2,4,2,1,4,13,11,11,6,5,7,40,2,4,-1.20805422690819
"669",1491530511,1,1,1,1,1,5,8,9,4,3,3,27,2,6,1.12411354379732
"670",1491759197,1,1,1,1,2,6,6,8,6,6,7,33,1,6,-0.377120799205949
"671",1491514367,2,2,2,2,3,11,8,11,11,8,10,48,10,7,0.246152097819666
"672",1567308116,2,2,2,1,2,9,6,6,6,6,5,29,7,5,0.642684729316485
"673",1490567005,1,1,1,1,1,5,6,6,6,6,6,30,5,7,1.47074229022351
"674",1635174779,1,1,1,1,3,7,6,8,6,6,6,32,1,8,0.00543769057925059
"675",1490716478,1,3,4,1,1,10,6,8,8,6,7,35,1,3,-0.428963105626168
"676",1491495104,4,4,4,4,4,20,6,9,5,5,5,30,10,4,0.161255914835654
"677",1490753365,1,1,1,1,1,5,6,8,7,6,9,36,1,6,0.8833991365569
"678",1491636412,3,3,3,1,3,13,4,4,3,6,2,19,1,4,0.0384915671430424
"679",1113422142,3,4,5,2,5,19,7,8,7,8,8,38,1,4,-0.428963105626168
"680",1185311152,2,4,4,1,5,16,7,8,6,2,2,25,7,2,0.0384915671430424
"681",1407777016,1,1,1,1,2,6,7,6,6,6,6,31,7,6,0.175230056547274
"682",1491506140,1,1,1,1,1,5,11,11,8,10,11,51,2,8,1.47074229022351
"683",1491101549,1,1,1,1,1,5,9,10,8,10,10,47,6,8,1.47074229022351
"684",1454138843,1,3,1,1,3,9,8,10,6,6,7,37,2,6,1.47074229022351
"685",1710598044,2,4,5,3,4,18,11,10,11,10,11,53,3,4,0.642684729316485
"686",1490722220,1,1,1,1,1,5,6,6,3,5,3,23,4,6,1.47074229022351
"687",1491193506,4,4,4,3,4,19,9,9,9,8,8,43,1,6,-0.617835206446364
"688",1490582011,4,4,4,3,4,19,5,7,7,7,7,33,5,4,1.47074229022351
"689",1491635592,1,4,3,3,5,16,11,10,11,9,11,52,4,2,-0.740599554138976
"690",1469172886,2,3,2,2,2,11,8,7,5,2,7,29,3,4,0.401970322076069
"691",1490720262,3,3,3,3,3,15,6,6,6,6,6,30,1,8,0.175230056547274
"692",1490574877,1,4,2,1,2,10,5,7,3,3,3,21,1,6,0.0384915671430424
"693",1490600919,1,4,3,3,3,14,4,5,5,4,7,25,1,5,-0.0654843506931415
"694",1582394806,3,3,2,1,4,13,3,4,3,2,2,14,3,6,1.47074229022351
"695",1491346538,1,3,3,2,3,12,9,9,8,5,10,41,2,5,-0.844575471975159
"696",1490635788,3,3,3,3,3,15,1,4,3,5,6,19,1,7,0.8833991365569
"697",1490586359,1,3,3,1,5,13,6,11,6,6,6,35,4,2,-1.20805422690819
"698",1491543331,4,2,2,2,3,13,9,8,9,8,7,41,3,6,-0.617835206446364
"699",1339642968,2,2,2,1,2,9,11,10,7,6,6,40,3,4,1.12411354379732
"700",1491410969,2,4,5,3,5,19,7,8,8,8,4,35,5,4,-1.20805422690819
"701",1491529280,1,1,1,1,4,8,7,7,2,2,2,20,4,8,1.36482795103773
"702",1491480558,2,5,5,5,5,22,11,11,11,11,11,55,4,7,0.175230056547274
"703",1491633324,3,3,3,3,3,15,6,10,10,8,10,44,7,6,-1.20805422690819
"704",1491517278,1,1,1,1,2,6,9,10,7,8,9,43,5,6,1.47074229022351
"705",1491763537,1,4,4,4,3,16,8,5,2,4,3,22,1,6,-0.306198757933557
"706",1617899849,3,4,3,1,4,15,8,5,8,8,4,33,1,2,0.161255914835654
"707",1490759348,5,5,5,5,4,24,11,11,6,3,6,37,3,2,0.0384915671430424
"708",1491508715,1,1,1,1,2,6,5,7,8,9,9,38,9,8,-1.20805422690819
"709",1490636942,4,1,1,1,2,9,9,9,6,7,9,40,7,7,0.161255914835654
"710",1652556604,2,2,3,1,2,10,9,8,7,5,6,35,2,6,1.12411354379732
"711",1652574847,1,3,2,1,1,8,8,7,2,2,6,25,1,7,1.47074229022351
"712",1528066447,3,2,3,1,3,12,6,9,5,8,9,37,1,6,0.486866505060081
"713",1491158178,4,5,4,4,4,21,6,8,6,6,7,33,1,2,0.0384915671430424
"714",1491292018,2,2,4,1,4,13,11,11,11,11,11,55,2,6,0.727580912300496
"715",1491590846,1,1,1,1,1,5,7,10,3,5,5,30,6,8,-0.428963105626168
"716",1491762738,1,1,1,1,1,5,6,6,6,6,8,32,2,3,0.642684729316485
"717",1491029487,2,4,2,3,4,15,8,7,7,7,6,35,1,4,-0.428963105626168
"718",1491517209,3,3,2,2,2,12,7,6,4,2,2,21,5,3,0.00543769057925059
"719",1318073441,3,4,2,3,3,15,9,6,6,7,6,34,9,6,0.161255914835654
"720",1491582078,3,3,3,2,4,15,5,5,5,6,6,27,8,6,-0.117326657113361
"721",1490628684,3,4,4,3,4,18,8,9,8,8,7,40,4,6,1.36482795103773
"722",1491725947,3,3,3,3,3,15,6,6,6,7,7,32,1,4,-1.20805422690819
"723",1688996124,4,3,3,4,2,16,9,9,9,6,9,42,1,6,-0.428963105626168
"724",1491368703,1,3,4,1,4,13,9,11,9,10,9,48,1,3,-1.20805422690819
"725",1705471628,1,1,1,1,1,5,9,11,10,9,8,47,10,8,0.401970322076069
"726",1652625521,3,4,4,3,4,18,6,6,9,6,6,33,1,2,0.415944463787689
"727",1491725648,4,5,4,4,4,21,8,8,10,8,8,42,3,6,-0.117326657113361
"728",1491748942,4,4,5,5,5,23,7,7,6,6,7,33,1,7,-0.688757247718756
"729",1491203022,5,1,2,1,2,11,2,5,6,9,2,24,1,7,-1.08528987921557
"730",1490563905,1,1,3,1,2,8,8,7,8,7,6,36,9,7,-1.20805422690819
"731",1654527920,3,2,2,2,3,12,3,5,2,5,5,20,9,8,0.8833991365569
"732",1491757468,1,1,1,1,1,5,8,7,5,3,3,26,9,7,1.47074229022351
"733",1490865138,1,4,4,5,4,18,11,4,10,3,7,35,9,4,-1.20805422690819
"734",1491501148,1,2,3,4,5,15,11,6,11,6,5,39,6,2,1.47074229022351
"735",1277639742,4,3,1,1,3,12,8,8,3,3,5,27,10,8,0.0384915671430424
"736",1515309746,1,1,1,1,1,5,7,7,7,7,7,35,2,8,0.486866505060081
"737",1491565952,1,1,3,1,1,7,11,10,8,6,10,45,6,4,-0.306198757933557
"738",1491531460,1,1,3,3,3,11,9,9,6,6,6,36,5,2,-1.20805422690819
"739",1491542495,2,2,3,1,4,12,11,10,7,7,7,42,1,6,-0.306198757933557
"740",1221643651,2,4,3,2,4,15,8,6,8,6,8,36,9,7,-1.20805422690819
"741",1584471811,5,5,3,3,5,21,6,6,6,6,6,30,2,2,-1.20805422690819
"742",1491632879,4,2,3,2,3,14,11,11,9,9,9,49,10,6,-1.20805422690819
"743",1491601371,3,3,3,1,1,11,6,6,8,6,6,32,3,4,-0.117326657113361
"744",1491356573,1,1,4,1,3,10,6,7,6,7,7,33,8,8,0.246152097819666
"745",1490931707,1,1,1,1,1,5,8,9,8,6,6,37,3,6,0.00543769057925059
"746",1490586258,1,1,1,1,1,5,11,11,11,10,11,54,4,2,-1.20805422690819
"747",1579223027,4,4,3,4,3,18,9,7,8,7,8,39,2,6,-0.740599554138976
"748",1409845322,5,5,5,5,5,25,11,11,11,11,11,55,3,2,0.642684729316485
"749",1491488569,1,1,1,1,4,8,6,8,6,6,6,32,1,8,1.12411354379732
"750",1148661078,3,3,3,3,3,15,6,6,6,6,6,30,5,4,-1.20805422690819
"751",1491529543,1,3,2,1,3,10,8,8,9,6,4,35,5,8,1.36482795103773
"752",1490570569,3,4,4,3,4,18,7,6,6,7,7,33,6,6,0.642684729316485
"753",1553232830,4,4,4,4,4,20,10,10,10,10,10,50,1,6,0.8833991365569
"754",1491519708,2,2,3,1,2,10,2,6,3,2,2,15,5,6,-1.20805422690819
"755",1574281446,3,4,3,1,3,14,6,6,6,6,6,30,6,3,-1.05223600265178
"756",1491765217,3,3,3,1,4,14,7,7,8,6,8,36,4,4,-0.688757247718756
"757",1294217322,3,3,3,2,4,15,6,6,6,5,7,30,2,6,-1.20805422690819
"758",1328530728,4,2,3,3,4,16,6,6,6,6,6,30,7,2,0.0384915671430424
"759",1261338333,4,4,4,4,4,20,7,7,7,7,7,35,4,6,1.36482795103773
"760",1491636493,3,3,3,1,3,13,7,9,6,6,6,34,3,5,0.727580912300496
"761",1522676211,5,5,5,5,5,25,11,8,10,10,10,49,6,6,-0.117326657113361
"762",1491697289,4,4,4,5,5,22,4,5,6,7,8,30,4,8,-0.0654843506931415
"763",1491758933,1,1,1,1,1,5,8,9,4,3,3,27,5,8,0.727580912300496
"764",1490729157,3,4,2,3,3,15,8,8,7,6,7,36,2,6,-1.20805422690819
"765",1490621050,3,3,3,2,3,14,10,8,7,6,8,39,2,2,-0.428963105626168
"766",1545651197,3,3,3,2,3,14,6,9,4,4,3,26,2,4,-0.117326657113361
"767",1651138410,5,5,3,4,5,22,4,6,7,8,6,31,2,7,1.12411354379732
"768",1652409624,4,3,3,3,4,17,10,11,10,7,8,46,6,3,-1.05223600265178
"769",1672956638,4,3,3,1,3,14,6,5,5,2,2,20,6,6,0.0384915671430424
"770",1491496239,2,4,1,1,1,9,7,8,6,6,6,33,4,7,0.727580912300496
"771",1491497182,1,2,2,1,4,10,11,10,6,2,5,34,9,5,-0.0654843506931415
"772",1491738866,1,1,1,1,1,5,6,9,7,1,2,25,9,6,0.401970322076069
"773",1490750059,1,3,3,1,4,12,6,8,5,6,6,31,9,6,0.415944463787689
"774",1561752308,3,3,3,3,3,15,6,6,6,6,6,30,6,5,-0.740599554138976
"775",1490584398,5,5,5,5,5,25,6,9,7,9,9,40,2,8,-1.20805422690819
"776",1491496449,3,4,2,1,3,13,8,6,6,6,6,32,4,4,-1.20805422690819
"777",1490567262,1,1,4,2,3,11,6,11,7,3,2,29,2,6,-1.20805422690819
"778",1491639102,1,1,1,1,2,6,3,4,4,4,5,20,3,7,-0.306198757933557
"779",1490576064,4,2,2,2,2,12,7,10,8,8,10,43,1,5,0.8833991365569
"780",1490755897,1,2,3,1,3,10,2,7,2,2,2,15,5,2,0.161255914835654
"781",1491603776,1,1,1,1,1,5,8,9,8,7,6,38,1,8,0.585736829755712
"782",1490581708,3,3,3,3,3,15,6,6,7,4,6,29,5,8,-0.306198757933557
"783",1490598202,3,3,3,3,3,15,6,6,6,6,6,30,2,6,-0.617835206446364
"784",1490716475,1,2,1,1,1,6,8,6,8,4,4,30,1,5,0.415944463787689
"785",1630089784,2,2,2,2,2,10,7,6,5,6,6,30,2,7,0.0384915671430424
"786",1490631466,4,5,4,4,5,22,9,11,11,7,11,49,4,4,-1.20805422690819
"787",1491596111,3,5,5,3,5,21,10,8,4,3,5,30,2,6,-0.740599554138976
"788",1322627060,1,1,1,1,2,6,10,8,7,6,7,38,4,6,0.8833991365569
"789",1635148993,5,4,3,2,4,18,11,10,7,9,9,46,4,4,0.0384915671430424
"790",1491488225,3,5,5,5,3,21,11,11,8,8,11,49,4,8,0.642684729316485
"791",1374642987,2,4,4,1,2,13,11,10,4,2,2,29,4,7,-0.740599554138976
"792",1363257578,1,1,1,1,1,5,11,11,7,7,6,42,8,2,-1.20805422690819
"793",1490717127,2,4,2,2,2,12,7,6,7,7,9,36,9,4,0.401970322076069
"794",1490625716,2,4,1,1,3,11,7,8,6,6,7,34,4,8,0.642684729316485
"795",1491747763,2,2,2,2,2,10,6,7,6,5,5,29,9,6,0.0384915671430424
"796",1490725709,1,1,1,1,1,5,3,8,4,2,8,25,4,8,0.345022422515297
"797",1520678147,3,4,5,4,4,20,11,11,11,11,11,55,4,2,-1.20805422690819
"798",1491513851,4,5,4,1,4,18,9,10,7,8,9,43,4,3,-0.117326657113361
"799",1491630862,1,3,2,2,2,10,7,6,6,6,7,32,2,6,1.31492406596711
"800",1547799633,1,1,1,1,1,5,9,6,6,6,6,33,2,2,1.47074229022351
"801",1490749166,1,3,5,3,5,17,10,10,6,6,7,39,2,2,0.0384915671430424
"802",1375227355,3,4,4,3,4,18,7,8,6,8,8,37,8,6,1.47074229022351
"803",1626183682,4,5,4,4,3,20,9,9,9,8,10,45,8,2,0.00543769057925059
"804",1491490087,4,4,4,4,4,20,8,9,9,9,8,43,5,8,-1.20805422690819
"805",1651128895,1,1,1,1,1,5,8,11,8,6,7,40,9,6,0.8833991365569
"806",1490714514,3,4,4,3,3,17,7,11,9,9,7,43,9,4,-1.20805422690819
"807",1697383562,3,3,3,3,3,15,6,6,6,6,6,30,4,6,1.47074229022351
"808",1490730587,1,1,3,1,1,7,9,11,6,6,6,38,4,7,1.47074229022351
"809",1491293509,5,4,4,4,5,22,7,7,9,3,8,34,8,5,-1.20805422690819
"810",1490864573,5,5,5,5,5,25,6,6,7,6,6,31,2,4,-1.20805422690819
"811",1490712308,3,2,3,2,3,13,7,9,4,6,11,37,2,5,0.246152097819666
"812",1378200510,1,1,1,1,1,5,7,7,6,8,8,36,1,8,-0.306198757933557
"813",1529906921,1,3,2,1,2,9,9,9,9,6,7,40,4,4,1.12411354379732
"814",1491775362,1,2,3,1,2,9,4,5,6,3,3,21,6,5,1.47074229022351
"815",1685635612,3,2,2,3,3,13,6,4,6,3,6,25,1,5,0.0384915671430424
"816",1611699237,1,1,1,1,1,5,8,8,10,8,8,42,7,7,1.47074229022351
"817",1490715485,2,3,3,4,2,14,8,9,4,4,4,29,1,2,0.8833991365569
"818",1490749684,2,3,2,2,3,12,10,9,6,6,8,39,4,6,-1.20805422690819
"819",1491510835,2,3,3,2,2,12,5,7,6,3,3,24,6,6,-0.428963105626168
"820",1491769146,3,3,3,3,3,15,5,5,4,4,5,23,7,8,-1.20805422690819
"821",1529887750,3,4,3,2,3,15,8,9,9,6,6,38,1,5,1.47074229022351
"822",1323497121,2,2,3,1,2,10,2,3,2,1,1,9,8,7,1.12411354379732
"823",1414633691,1,1,1,1,1,5,7,9,7,6,6,35,1,6,1.36482795103773
"824",1491503941,3,2,1,1,1,8,8,8,8,7,9,40,7,5,0.00543769057925059
"825",1491746524,1,1,1,1,1,5,7,4,2,1,2,16,1,4,0.246152097819666
"826",1414894253,3,3,3,3,3,15,7,7,4,6,8,32,5,7,-1.05223600265178
"827",1491091321,3,4,5,5,5,22,6,6,6,6,6,30,1,2,-1.20805422690819
"828",1491522112,2,4,3,3,3,15,11,7,11,9,10,48,7,6,-0.740599554138976
"829",1490755398,2,4,4,2,3,15,10,10,9,9,8,46,1,6,-0.740599554138976
"830",1491525898,1,3,3,3,3,13,9,9,8,8,8,42,4,4,0.0384915671430424
"831",1491633916,1,1,1,1,1,5,9,8,9,6,6,38,6,6,-0.306198757933557
"832",1491639948,1,1,1,1,1,5,6,10,6,5,6,33,3,8,0.8833991365569
"833",1561737117,3,4,3,3,3,16,8,9,7,6,6,36,3,6,-0.740599554138976
"834",1490588087,2,3,1,1,1,8,9,8,6,6,6,35,10,6,0.161255914835654
"835",1491688905,2,2,1,1,2,8,7,8,9,8,10,42,5,8,-0.428963105626168
"836",1490709903,1,2,2,2,3,10,9,9,7,6,9,40,3,7,1.12411354379732
"837",1491743349,1,1,4,1,3,10,11,11,10,9,10,51,2,6,-1.20805422690819
"838",1260644372,1,1,1,1,1,5,9,9,8,6,6,38,2,8,1.47074229022351
"839",1261391476,1,1,1,1,1,5,8,7,7,6,6,34,3,7,0.161255914835654
"840",1490596523,2,4,4,2,3,15,8,8,4,3,9,32,3,6,-0.0654843506931415
"841",1219495531,5,4,4,4,4,21,10,9,11,9,10,49,3,3,0.161255914835654
"842",1491629121,3,3,3,3,3,15,6,6,6,6,6,30,8,4,0.8833991365569
"843",1520419579,1,2,1,1,1,6,9,7,7,3,4,30,5,4,1.36482795103773
"844",1491530544,1,4,2,1,2,10,9,8,5,6,6,34,5,8,0.161255914835654
"845",1374594514,2,3,2,1,4,12,7,7,8,6,7,35,7,6,0.246152097819666
"846",1491490019,3,2,3,2,4,14,6,8,6,2,3,25,8,5,0.486866505060081
"847",1442249066,3,5,5,4,5,22,11,10,9,10,11,51,8,3,-1.20805422690819
"848",1704219471,4,4,3,4,4,19,8,7,8,8,8,39,6,5,0.00543769057925059
"849",1490598351,4,5,3,2,4,18,7,11,6,6,7,37,5,3,0.0384915671430424
"850",1491472374,1,1,1,1,2,6,8,9,9,6,6,38,4,5,1.12411354379732
"851",1491485847,3,4,4,2,4,17,8,9,7,6,6,36,2,6,0.161255914835654
"852",1189036520,1,4,3,2,2,12,2,2,3,2,2,11,3,5,-1.20805422690819
"853",1491501892,1,1,1,1,4,8,6,6,6,6,6,30,3,5,-1.20805422690819
"854",1491748614,1,1,1,1,3,7,9,7,9,9,9,43,4,8,1.36482795103773
"855",1491528157,1,4,5,3,4,17,11,11,1,11,11,45,5,8,0.246152097819666
"856",1490733289,1,1,1,1,1,5,8,11,11,7,7,44,4,4,-0.117326657113361
"857",1490597413,1,4,4,1,4,14,10,9,6,9,9,43,1,7,-0.377120799205949
"858",1591897091,4,3,4,5,5,21,8,6,9,6,7,36,1,7,0.8833991365569
"859",1491057160,1,2,1,1,2,7,6,7,7,7,6,33,1,6,1.47074229022351
"860",1609809223,4,2,4,1,2,13,7,8,9,8,9,41,8,7,1.47074229022351
"861",1370972603,3,4,1,1,3,12,11,8,7,8,7,41,5,8,0.642684729316485
"862",1536000290,1,2,4,1,5,13,10,10,9,8,3,40,3,8,-1.20805422690819
"863",1491739915,2,2,1,1,1,7,9,9,8,7,7,40,4,4,1.47074229022351
"864",1491753814,1,3,2,1,4,11,9,10,8,8,8,43,1,2,1.47074229022351
"865",1491629899,1,1,1,1,1,5,6,8,3,2,2,21,4,8,1.47074229022351
"866",1490710616,1,2,3,1,2,9,8,9,8,9,10,44,2,8,-1.20805422690819
"867",1491516077,1,2,4,1,4,12,6,6,6,6,6,30,10,7,0.401970322076069
"868",1490753707,1,1,1,1,3,7,11,9,8,9,7,44,10,3,0.0384915671430424
"869",1491517184,2,2,4,2,2,12,6,7,5,7,7,32,5,3,0.00543769057925059
"870",1490578102,1,4,4,3,3,15,11,11,11,11,11,55,1,6,-1.20805422690819
"871",1711516502,3,2,1,1,1,8,9,8,7,5,7,36,1,6,0.0384915671430424
"872",1490590872,4,4,5,5,5,23,10,7,7,8,8,40,6,6,-0.117326657113361
"873",1490627385,1,3,3,1,3,11,6,9,9,6,4,34,3,7,-0.740599554138976
"874",1491509069,3,3,3,2,3,14,6,7,6,6,6,31,4,7,0.161255914835654
"875",1545428500,1,2,1,1,1,6,11,9,7,9,6,42,4,7,0.0384915671430424
"876",1491770404,2,2,3,2,1,10,6,8,8,8,6,36,5,8,0.401970322076069
"877",1491510312,3,4,2,2,4,15,11,11,11,11,11,55,5,8,-0.306198757933557
"878",1490697753,3,3,3,3,3,15,11,9,8,8,8,44,1,4,-1.20805422690819
"879",1490702302,1,1,1,1,1,5,10,8,4,2,9,33,3,7,-0.617835206446364
"880",1491509611,3,4,4,1,4,16,4,10,3,3,6,26,5,4,-1.20805422690819
"881",1491497555,1,1,4,1,3,10,10,11,10,6,9,46,4,6,1.36482795103773
"882",1490625047,3,1,1,1,3,9,8,8,6,6,6,34,4,8,1.47074229022351
"883",1491007495,4,4,5,4,5,22,9,10,10,10,11,50,7,5,-0.207328433237925
"884",1491756944,1,4,2,2,3,12,8,7,6,3,3,27,1,4,1.36482795103773
"885",1491286695,5,5,5,5,5,25,6,6,6,6,6,30,1,2,-1.20805422690819
"886",1490752081,1,1,1,1,2,6,8,8,8,6,8,38,5,5,1.47074229022351
"887",1490709245,3,4,3,3,4,17,11,8,9,6,6,40,1,8,0.0384915671430424
"888",1490749995,2,3,2,2,2,11,11,9,7,6,7,40,3,5,0.175230056547274
"889",1490712518,1,1,1,1,1,5,5,4,7,5,5,26,1,8,1.47074229022351
"890",1491414557,1,2,2,2,2,9,4,8,7,6,7,32,1,5,0.8833991365569
"891",1491625900,3,3,3,3,4,16,10,10,8,8,8,44,1,6,-1.20805422690819
"892",1491746212,1,1,1,1,1,5,5,7,6,2,2,22,1,6,0.8833991365569
"893",1578593702,2,2,2,2,2,10,6,6,3,5,5,25,1,7,0.161255914835654
"894",1604676800,4,4,4,4,4,20,6,7,8,9,10,40,7,7,-0.740599554138976
"895",1491765960,3,4,4,3,3,17,11,11,6,9,11,48,1,6,-1.20805422690819
"896",1511815048,1,1,1,1,1,5,5,6,7,6,6,30,1,8,-1.20805422690819
"897",1491527431,2,2,3,2,5,14,8,11,8,6,6,39,5,3,1.20900972678133
"898",1491569961,1,1,1,1,3,7,3,11,5,6,7,32,3,6,0.8833991365569
"899",1490760076,5,4,3,1,2,15,9,7,7,8,8,39,4,5,-0.617835206446364
"900",1490713869,1,4,3,2,3,13,8,8,6,6,6,34,7,7,1.47074229022351
"901",1490658447,1,2,3,1,3,10,6,8,7,6,7,34,7,8,0.642684729316485
"902",1491630569,3,3,3,2,3,14,6,8,10,6,6,36,7,8,-1.20805422690819
"903",1247632531,3,4,1,1,5,14,6,7,6,8,6,33,3,7,-1.05223600265178
"904",1490665025,3,2,3,3,4,15,6,8,10,9,10,43,6,7,-1.05223600265178
"905",1491724371,2,2,2,2,3,11,6,7,8,7,6,34,7,4,-0.740599554138976
"906",1491508134,1,2,2,1,2,8,5,9,1,1,2,18,1,4,1.36482795103773
"907",1491552309,3,3,3,3,3,15,11,11,11,11,11,55,1,8,0.691651168941495
"908",1491518258,2,1,1,1,1,6,11,8,6,9,11,45,1,5,0.00543769057925059
"909",1491780257,1,2,1,1,3,8,9,10,3,3,6,31,1,6,-0.136406391965533
"910",1490694157,5,5,5,5,5,25,11,11,11,10,11,54,1,8,-0.428963105626168
"911",1491315319,4,5,4,4,4,21,7,8,9,10,7,41,2,7,0.345022422515297
"912",1516551614,1,3,2,1,2,9,10,8,8,6,7,39,1,5,0.401970322076069
"913",1682873545,3,3,4,3,3,16,6,6,6,6,6,30,5,2,-1.20805422690819
"914",1490619870,2,3,2,1,1,9,2,8,4,2,2,18,5,6,0.642684729316485
"915",1490715490,4,3,3,4,2,16,9,10,6,6,7,38,7,6,-0.740599554138976
"916",1673019157,3,2,1,1,3,10,6,8,5,4,1,24,5,5,0.401970322076069
"917",1490606348,4,4,3,3,3,17,11,11,11,8,8,49,4,2,-0.117326657113361
"918",1490711892,1,1,1,1,1,5,4,5,8,6,6,29,4,4,1.47074229022351
"919",1538974501,1,4,1,1,4,11,6,8,6,4,6,30,1,7,-1.05223600265178
"920",1490727399,1,1,1,1,1,5,9,9,8,9,9,44,3,6,1.47074229022351
"921",1490808025,1,1,1,1,4,8,7,7,6,5,6,31,6,8,-1.20805422690819
"922",1490755725,1,2,3,4,5,15,1,2,3,5,5,16,3,8,0.642684729316485
"923",1491213450,3,3,2,2,3,13,5,5,10,6,8,34,5,6,0.401970322076069
"924",1490569990,1,3,3,1,2,10,11,6,9,7,9,42,3,8,1.47074229022351
"925",1490591492,1,2,1,1,1,6,6,6,6,6,6,30,4,4,-1.05223600265178
"926",1491768849,3,3,3,3,3,15,6,6,6,6,6,30,4,4,-1.20805422690819
"927",1490759878,1,1,1,1,2,6,8,6,7,6,6,33,4,7,0.0384915671430424
"928",1490596907,1,1,1,1,1,5,5,7,6,6,3,27,4,6,0.161255914835654
"929",1547085993,3,4,4,3,3,17,6,6,6,6,7,31,3,4,0.161255914835654
"930",1490581740,1,3,3,1,3,11,8,8,8,4,4,32,2,4,1.47074229022351
"931",1490615931,1,1,1,1,1,5,11,11,8,9,9,48,2,3,-0.117326657113361
"932",1491303458,2,2,1,1,2,8,9,10,10,10,11,50,8,6,1.36482795103773
"933",1491711782,1,3,1,1,1,7,8,10,5,5,7,35,4,5,1.12411354379732
"934",1490625714,3,2,2,3,4,14,8,5,5,7,7,32,1,5,-0.207328433237925
"935",1633011253,4,4,5,5,5,23,11,10,9,8,10,48,7,7,-0.740599554138976
"936",1379154854,4,1,1,1,2,9,7,7,8,6,8,36,7,4,-0.117326657113361
"937",1491462670,1,4,2,3,2,12,11,11,11,6,11,50,3,2,-1.20805422690819
"938",1650470587,2,3,2,1,3,11,9,9,8,6,8,40,2,5,-1.20805422690819
"939",1491764312,3,5,4,3,4,19,7,8,7,8,9,39,10,3,-1.20805422690819
"940",1491781753,2,4,3,3,3,15,9,9,9,9,9,45,10,7,0.161255914835654
"941",1491777136,1,1,1,1,2,6,6,6,4,3,3,22,5,6,1.47074229022351
"942",1491035929,2,3,1,1,2,9,6,3,3,3,7,22,1,4,0.161255914835654
"943",1522997646,1,1,3,1,1,7,11,11,9,6,8,45,1,4,1.47074229022351
"944",1526800483,2,3,3,3,4,15,7,7,9,7,7,37,2,5,0.8833991365569
"945",1490684318,2,4,3,2,4,15,3,3,7,3,3,19,2,7,0.8833991365569
"946",1490755433,2,4,4,3,5,18,7,8,7,6,6,34,2,4,-0.117326657113361
"947",1491501012,1,1,1,1,1,5,6,7,8,7,8,36,10,8,0.0384915671430424
"948",1490667906,1,3,1,1,4,10,9,10,6,5,5,35,7,4,-1.20805422690819
"949",1491215509,4,4,4,5,5,22,8,8,7,8,9,40,7,8,0.0384915671430424
"950",1491758304,3,3,3,3,3,15,6,7,4,6,5,28,2,2,-1.20805422690819
"951",1592592621,4,2,3,4,4,17,5,9,8,7,4,33,7,7,0.00543769057925059
"952",1490724086,1,1,3,1,3,9,11,6,2,6,7,32,1,4,-1.20805422690819
"953",1490751573,5,4,1,1,4,15,9,9,8,8,7,41,2,8,0.642684729316485
"954",1490728355,1,1,2,1,1,6,8,8,7,2,3,28,1,6,0.0384915671430424
"955",1491758143,1,1,3,1,3,9,7,6,7,3,4,27,3,4,1.36482795103773
"956",1128209960,2,2,2,1,2,9,11,11,2,8,11,43,5,6,-0.117326657113361
"957",1490646512,3,3,3,3,3,15,6,6,6,6,6,30,10,6,0.8833991365569
"958",1491629034,2,1,1,1,4,9,2,2,2,2,1,9,6,6,-1.20805422690819
"959",1491774724,1,1,1,1,1,5,8,7,4,2,2,23,4,8,-0.117326657113361
"960",1490578929,1,3,2,1,3,10,6,5,5,6,3,25,1,8,-1.20805422690819
"961",1490809075,1,1,1,1,2,6,6,10,6,8,8,38,5,8,0.0384915671430424
"962",1491752160,3,3,3,3,3,15,6,6,6,6,6,30,5,5,0.968295319540912
"963",1490750444,3,3,3,3,3,15,8,6,6,6,7,33,5,4,-1.20805422690819
"964",1491782155,3,4,4,2,3,16,8,6,9,7,6,36,1,8,0.0384915671430424
"965",1490654303,1,3,1,1,3,9,2,4,2,2,2,12,1,7,0.8833991365569
"966",1490704181,4,4,4,4,4,20,11,9,10,8,9,47,2,4,-0.740599554138976
"967",1490712152,1,1,1,2,3,8,2,1,1,6,7,17,5,8,0.642684729316485
"968",1491503306,3,3,2,1,1,10,3,3,2,2,3,13,5,2,0.161255914835654
"969",1491485062,1,3,1,1,2,8,6,6,4,3,3,22,1,5,0.161255914835654
"970",1652704511,3,2,2,2,3,12,6,6,6,5,5,28,5,6,0.0384915671430424
"971",1490760535,1,2,3,3,4,13,5,6,7,8,8,34,8,3,-0.448042840478341
"972",1226221453,3,3,1,1,1,9,4,3,7,6,6,26,4,8,-1.20805422690819
"973",1490582293,4,3,3,3,5,18,11,11,6,6,11,45,2,8,0.161255914835654
"974",1073166788,2,4,4,4,5,19,6,8,7,7,7,35,4,8,-0.117326657113361
"975",1490628103,2,1,1,1,1,6,10,10,10,9,9,48,5,6,0.401970322076069
"976",1653340468,1,4,3,4,3,15,10,10,7,7,7,41,4,5,-1.20805422690819
"977",1490685944,1,3,4,1,3,12,7,9,6,5,8,35,3,8,0.0384915671430424
"978",1491498822,3,3,2,1,3,12,8,5,6,7,6,32,2,6,-1.05223600265178
"979",1490807092,1,3,1,1,2,8,6,8,10,6,6,36,1,7,0.486866505060081
"980",1490697535,1,3,1,1,1,7,8,9,11,9,9,46,6,6,0.0384915671430424
"981",1437078569,2,1,1,1,2,7,9,8,6,5,7,35,8,4,-0.306198757933557
"982",1490723904,2,1,1,1,5,10,11,11,11,11,11,55,4,6,1.36482795103773
"983",1491743082,4,3,2,2,3,14,9,8,8,5,8,38,1,8,1.12411354379732
"984",1499452613,5,5,1,1,1,13,10,11,9,8,10,48,1,7,0.0384915671430424
"985",1490627849,2,3,2,1,3,11,7,5,4,2,2,20,2,6,1.47074229022351
"986",1491530966,3,2,3,2,2,12,7,6,6,6,7,32,2,5,1.12411354379732
"987",1490712242,2,4,1,1,1,9,11,8,2,6,2,29,1,7,-0.428963105626168
"988",1491519122,3,3,3,2,3,14,6,7,7,5,5,30,3,4,-1.20805422690819
"989",1491640826,1,2,2,1,4,10,7,8,5,2,2,24,3,3,-1.20805422690819
"990",1491775928,4,4,2,1,1,12,8,7,10,9,8,42,2,8,0.642684729316485
"991",1491706607,2,2,2,2,2,10,8,7,7,7,8,37,7,6,0.0384915671430424
"992",1441082799,1,2,2,2,3,10,4,8,6,5,7,30,6,3,0.161255914835654
"993",1491749933,1,1,2,1,1,6,5,6,5,3,5,24,6,8,1.20900972678133
"994",1490753024,1,4,3,1,4,13,9,8,2,1,2,22,1,2,-0.740599554138976
"995",1491752735,1,1,1,1,1,5,11,6,6,11,6,40,2,8,-0.929471654959171
"996",1393145149,1,1,1,1,1,5,11,11,11,11,11,55,2,6,-1.20805422690819
"997",1491526116,1,3,3,2,3,12,8,9,6,5,7,35,2,8,-0.117326657113361
"998",1647828475,3,3,3,3,3,15,6,6,6,6,6,30,2,4,0.642684729316485
"999",1491625473,1,1,1,1,1,5,11,11,11,11,11,55,3,4,1.47074229022351
"1000",1490750624,1,2,1,1,3,8,5,6,4,6,5,26,3,7,1.47074229022351
"1001",1490576488,1,1,3,1,4,10,8,10,6,2,11,37,10,7,0.642684729316485
"1002",1500871669,1,4,4,1,4,14,2,7,2,6,6,23,8,3,-1.20805422690819
"1003",1490716674,2,4,3,1,5,15,10,5,8,7,6,36,6,6,-0.740599554138976
"1004",1491780413,1,1,1,1,1,5,8,7,6,5,5,31,10,6,0.161255914835654
"1005",1490676215,4,4,4,4,4,20,8,8,8,8,8,40,10,5,-0.428963105626168
"1006",1632769675,1,4,1,1,2,9,11,11,8,6,2,38,9,4,-0.603861064734744
"1007",1598532256,1,1,3,2,3,10,7,8,8,9,9,41,2,2,0.00543769057925059
"1008",1490753737,1,1,1,1,1,5,9,9,5,6,7,36,10,5,0.246152097819666
"1009",1490688137,1,1,4,2,2,10,10,9,8,9,7,43,5,4,0.8833991365569
"1010",1491572692,3,3,3,3,3,15,6,6,6,6,6,30,5,2,-1.08528987921557
"1011",1613569225,4,4,4,4,5,21,10,9,10,10,11,50,5,6,0.161255914835654
"1012",1490804748,3,3,3,3,3,15,9,9,10,10,10,48,5,2,-0.740599554138976
"1013",1610717236,3,4,4,3,5,19,6,6,8,8,7,35,5,5,1.12411354379732
"1014",1490759340,1,1,1,1,1,5,2,10,3,1,2,18,5,2,-1.20805422690819
"1015",1296353793,1,1,1,1,1,5,1,8,2,1,1,13,5,5,-0.844575471975159
"1016",1651086511,3,5,2,4,1,15,11,9,6,9,6,41,5,2,-1.08528987921557
"1017",1490677853,1,5,2,1,5,14,11,11,9,1,6,38,5,5,-1.20805422690819
"1018",1491630030,1,1,1,1,1,5,11,11,9,9,11,51,5,2,0.0384915671430424
"1019",1491435384,2,4,3,1,3,13,8,8,7,8,8,39,5,6,-1.20805422690819
"1020",1491632590,3,4,3,4,4,18,7,5,6,4,4,26,5,6,0.00543769057925059
"1021",1490721650,1,3,3,1,3,11,6,7,7,7,6,33,5,5,-1.20805422690819
"1022",1491574483,3,3,4,3,3,16,6,6,6,5,5,28,5,6,-1.20805422690819
"1023",1490749224,2,2,2,2,2,10,6,7,6,6,6,31,5,6,-1.05223600265178
"1024",1604992768,1,3,3,2,4,13,4,4,5,4,4,21,5,2,-1.20805422690819
"1025",1491750054,2,3,2,1,2,10,7,5,6,6,7,31,5,7,0.8833991365569
"1026",1490595234,5,4,4,4,5,22,7,7,4,5,5,28,5,6,-1.20805422690819
"1027",1680542033,1,1,1,1,1,5,7,11,8,5,6,37,5,2,0.0384915671430424
"1028",1522679905,1,3,2,1,3,10,10,10,8,9,10,47,5,6,-0.117326657113361
"1029",1704205082,1,4,4,2,3,14,11,11,11,7,11,51,5,2,-0.603861064734744
"1030",1590366419,2,3,2,3,4,14,9,10,8,7,5,39,5,4,1.12411354379732
"1031",1610860696,4,3,4,3,3,17,6,6,6,6,6,30,5,6,-1.20805422690819
"1032",1490726524,3,3,3,3,3,15,6,6,6,6,6,30,5,2,-0.117326657113361
"1033",1181599229,3,3,3,3,3,15,6,6,6,6,6,30,5,8,-1.20805422690819
"1034",1608861544,3,4,4,4,4,19,10,10,8,6,7,41,5,6,-1.20805422690819
"1035",1650977438,1,2,1,1,1,6,8,7,7,7,6,35,5,6,-1.20805422690819
"1036",1672259278,1,2,1,1,3,8,9,9,6,6,8,38,5,3,-1.20805422690819
"1037",1491542037,3,3,3,1,3,13,6,2,6,6,6,26,5,8,0.8833991365569
"1038",1473822265,1,5,5,5,5,21,6,8,4,7,9,34,5,3,-0.117326657113361
"1039",1491529244,1,1,3,2,4,11,9,9,7,8,9,42,5,2,0.0384915671430424
"1040",1490690548,1,2,4,1,4,12,8,7,5,4,4,28,5,4,-1.20805422690819
"1041",1520435048,2,1,1,1,1,6,11,11,10,11,11,54,5,8,1.47074229022351
"1042",1622208642,1,1,3,1,3,9,8,11,3,9,6,37,5,7,-1.20805422690819
"1043",1624777405,3,4,3,2,3,15,11,11,11,11,11,55,5,2,0.00543769057925059
"1044",1416804473,4,5,5,2,5,21,10,10,6,6,6,38,5,6,-0.117326657113361
"1045",1491486771,1,1,1,1,1,5,6,7,6,6,6,31,5,3,0.00543769057925059
"1046",1491489188,2,4,4,1,5,16,8,9,6,3,2,28,5,3,-1.20805422690819
"1047",1490716447,1,3,3,1,2,10,6,9,6,6,6,33,5,4,-1.05223600265178
"1048",1491500691,1,3,3,3,5,15,6,6,6,6,6,30,5,2,-1.20805422690819
"1049",1491264068,4,3,3,1,1,12,5,7,3,8,7,30,5,2,1.47074229022351
"1050",1610519858,1,2,2,2,3,10,8,8,8,8,8,40,5,5,-1.20805422690819
"1051",1490633431,5,4,3,3,4,19,6,6,6,6,6,30,5,5,1.47074229022351
"1052",1491142132,1,1,1,2,5,10,11,11,11,11,11,55,5,3,-0.428963105626168
"1053",1490755385,1,4,2,1,4,12,8,10,5,3,7,33,5,5,0.642684729316485
"1054",1490604535,2,2,2,3,4,13,4,5,5,2,2,18,5,2,1.12411354379732
"1055",1490757896,1,4,3,3,5,16,7,11,7,5,8,38,5,3,-1.20805422690819
"1056",1491772293,4,5,4,5,4,22,9,7,8,9,8,41,5,8,0.175230056547274
"1057",1491077077,1,1,3,1,3,9,8,11,6,6,8,39,5,4,-0.617835206446364
"1058",1491758583,3,3,3,4,3,16,6,6,6,6,6,30,5,6,0.0384915671430424
"1059",1513878105,3,4,4,2,4,17,8,8,9,6,7,38,5,2,0.0384915671430424
"1060",1490723114,1,5,5,5,5,21,7,8,8,8,8,39,5,2,-1.20805422690819
"1061",1490761412,4,4,5,2,3,18,8,6,7,6,7,34,5,5,0.161255914835654
"1062",1580022880,2,4,4,2,5,17,9,11,6,6,6,38,5,6,0.175230056547274
"1063",1604617195,5,5,5,5,5,25,4,4,4,4,4,20,5,4,1.47074229022351
"1064",1712349793,3,5,5,4,4,21,11,8,8,6,6,39,5,3,-1.20805422690819
"1065",1491519742,4,4,4,4,4,20,8,7,6,5,8,34,5,4,-0.117326657113361
"1066",1490718654,2,4,3,3,4,16,6,4,4,6,3,23,9,5,0.0384915671430424
"1067",1319604040,1,1,4,4,4,14,11,11,11,6,7,46,4,8,-1.20805422690819
"1068",1491676027,3,3,3,3,3,15,6,6,6,6,6,30,3,8,-1.20805422690819
"1069",1500644296,2,4,2,3,3,14,3,4,6,4,4,21,7,3,-1.20805422690819
"1070",1490711681,3,2,3,3,4,15,7,6,7,7,7,34,8,8,-0.740599554138976
"1071",1490573819,1,1,1,1,1,5,8,9,4,5,7,33,4,7,0.486866505060081
"1072",1529971745,2,1,4,1,2,10,8,7,9,6,8,38,3,6,0.642684729316485
"1073",1490749109,3,3,3,3,3,15,11,11,7,5,8,42,3,4,-0.740599554138976
"1074",1491760498,2,4,2,3,2,13,6,6,6,6,6,30,4,5,1.47074229022351
"1075",1490750652,1,4,4,1,4,14,7,6,5,3,7,28,5,2,-1.20805422690819
"1076",1491716813,1,1,1,1,3,7,7,7,6,6,7,33,5,6,-1.20805422690819
"1077",1490702399,3,2,3,2,3,13,8,8,6,6,7,35,2,4,0.401970322076069
"1078",1491718331,2,3,3,3,3,14,7,8,8,7,6,36,4,4,-1.20805422690819
"1079",1586439106,1,2,2,2,3,10,2,3,4,5,6,20,5,3,-1.20805422690819
"1080",1490686672,2,3,5,4,5,19,8,8,6,6,9,37,3,6,-0.688757247718756
"1081",1491567135,2,2,2,1,2,9,8,6,8,6,9,37,5,5,0.00543769057925059
"1082",1490862472,3,3,3,3,4,16,7,6,6,6,6,31,1,5,-1.05223600265178
"1083",1385338776,2,2,2,2,2,10,9,10,7,6,7,39,2,2,-0.306198757933557
"1084",1490751632,4,5,4,4,4,21,8,10,9,9,9,45,1,2,1.47074229022351
"1085",1326548582,1,2,2,1,2,8,9,9,11,5,10,44,4,2,0.00543769057925059
"1086",1491576900,4,4,4,4,5,21,6,6,6,6,6,30,1,2,-0.740599554138976
"1087",1490726689,1,4,2,3,2,12,10,8,8,7,9,42,1,6,0.0384915671430424
"1088",1491613094,1,1,1,1,2,6,8,10,3,2,8,31,2,5,0.8833991365569
"1089",1490994829,1,1,2,1,2,7,5,8,8,5,6,32,5,7,1.47074229022351
"1090",1491588315,2,1,3,1,2,9,9,7,7,6,8,37,5,8,-1.08528987921557
"1091",1491487856,3,1,2,2,3,11,2,6,6,2,3,19,5,5,0.0384915671430424
"1092",1670405804,3,3,3,3,3,15,6,6,6,6,6,30,2,7,-0.306198757933557
"1093",1490748794,2,3,4,4,5,18,9,9,9,9,9,45,6,6,0.161255914835654
"1094",1491526102,3,1,1,1,2,8,10,9,7,6,9,41,3,4,0.246152097819666
"1095",1490800535,1,1,1,1,2,6,9,8,5,5,3,30,6,6,0.104308015274882
"1096",1491500759,3,3,3,3,3,15,6,6,6,6,6,30,1,6,1.47074229022351
"1097",1490741374,2,2,2,2,2,10,5,7,5,3,3,23,9,8,1.36482795103773
"1098",1491639051,1,3,1,1,3,9,9,9,6,7,8,39,8,8,-0.688757247718756
"1099",1491634300,2,4,3,1,3,13,9,10,6,6,7,38,2,7,0.0384915671430424
"1100",1491647694,3,4,2,2,3,14,3,10,10,6,10,39,1,3,0.161255914835654
"1101",1490751046,1,2,2,1,1,7,4,6,4,4,2,20,2,8,0.0384915671430424
"1102",1459263779,3,3,3,2,3,14,6,7,5,6,6,30,9,5,-0.117326657113361
"1103",1491400968,2,1,1,1,1,6,8,9,6,6,6,35,2,6,-0.207328433237925
"1104",1491778857,1,1,1,1,1,5,5,5,7,5,5,27,2,2,-0.117326657113361
"1105",1490752217,1,4,4,4,2,15,9,9,6,6,6,36,1,2,1.47074229022351
"1106",1491521092,2,4,3,3,3,15,8,8,6,6,4,32,2,5,1.12411354379732
"1107",1491755713,1,3,3,1,3,11,9,10,7,7,10,43,5,7,0.486866505060081
"1108",1604731768,2,4,4,2,5,17,9,11,11,9,11,51,7,7,0.104308015274882
"1109",1491208201,1,1,1,1,3,7,8,7,6,6,6,33,3,4,1.47074229022351
"1110",1491525294,1,1,1,1,1,5,7,8,11,11,7,44,3,8,1.47074229022351
"1111",1491019329,1,4,4,1,4,14,11,11,9,5,7,43,3,6,0.246152097819666
"1112",1491776077,3,4,2,1,5,15,5,6,7,2,6,26,3,8,0.161255914835654
"1113",1641959753,4,4,4,2,4,18,7,8,6,6,8,35,2,6,-0.117326657113361
"1114",1491496303,2,3,3,3,3,14,5,4,4,3,3,19,1,5,1.31492406596711
"1115",1610738875,4,2,2,1,2,11,5,6,8,7,7,33,5,8,0.0384915671430424
"1116",1490723236,1,1,1,1,1,5,7,8,7,1,1,24,3,7,0.161255914835654
"1117",1581114036,1,1,1,1,4,8,6,8,7,4,4,29,5,7,0.345022422515297
"1118",1491761055,3,3,3,3,3,15,6,6,6,6,6,30,1,2,0.0384915671430424
"1119",1491777637,1,1,1,1,3,7,5,9,6,2,7,29,1,5,-1.20805422690819
"1120",1694359376,1,1,1,1,1,5,6,6,6,6,6,30,4,8,1.47074229022351
"1121",1490757378,1,3,3,3,2,12,11,10,8,6,11,46,1,6,0.345022422515297
"1122",1464470171,3,3,2,1,5,14,9,10,6,6,2,33,1,2,-1.20805422690819
"1123",1530629717,4,4,4,2,4,18,9,7,7,6,7,36,3,7,-0.740599554138976
"1124",1491767661,3,2,3,3,3,14,6,7,7,6,6,32,6,7,0.00543769057925059
"1125",1247632788,3,3,3,3,3,15,10,10,10,10,10,50,3,6,0.0384915671430424
"1126",1490760195,3,3,3,3,3,15,6,9,11,6,11,43,3,2,0.175230056547274
"1127",1491068341,1,1,3,3,5,13,8,9,9,8,8,42,9,2,-0.740599554138976
"1128",1490578126,2,2,2,2,2,10,9,8,8,8,9,42,2,8,0.727580912300496
"1129",1490573582,2,2,2,2,2,10,10,9,9,3,7,38,2,6,-1.20805422690819
"1130",1490755649,4,3,5,2,4,18,9,10,8,8,10,45,3,8,-0.428963105626168
"1131",1490716854,1,1,3,1,1,7,3,4,8,3,7,25,6,6,0.0384915671430424
"1132",1490595938,3,3,3,3,4,16,6,6,6,6,6,30,7,6,0.00543769057925059
"1133",1718494027,3,2,1,1,1,8,8,8,9,9,8,42,6,6,-0.740599554138976
"1134",1491441776,1,1,1,1,1,5,11,11,9,11,11,53,2,7,0.175230056547274
"1135",1717251065,4,4,2,3,3,16,9,7,9,8,7,40,4,6,-1.20805422690819
"1136",1490702424,3,1,1,1,1,7,8,9,9,7,7,40,6,6,0.401970322076069
"1137",1490758402,4,4,5,5,5,23,6,11,6,6,6,35,1,8,1.12411354379732
"1138",1633653522,3,3,4,4,4,18,6,5,7,5,7,30,9,5,-0.617835206446364
"1139",1687388876,3,4,4,1,1,13,1,9,6,6,1,23,1,7,0.0384915671430424
"1140",1491763673,2,1,1,1,1,6,4,9,8,2,5,28,5,2,0.8833991365569
"1141",1491524187,2,3,2,1,2,10,9,9,9,9,9,45,2,6,-1.20805422690819
"1142",1516147172,3,3,3,3,3,15,6,5,6,7,7,31,2,6,-0.617835206446364
"1143",1353374503,1,1,2,1,2,7,6,6,4,4,4,24,4,6,1.12411354379732
"1144",1651043719,1,1,3,1,1,7,9,11,7,2,5,34,1,4,0.642684729316485
"1145",1491366536,1,1,1,1,1,5,7,8,9,6,6,36,3,8,0.401970322076069
"1146",1652854226,3,3,4,4,3,17,9,8,8,8,7,40,1,8,-1.20805422690819
"1147",1490720952,1,3,1,3,2,10,11,11,8,8,11,49,1,7,0.642684729316485
"1148",1674602271,3,2,1,3,2,11,9,9,9,9,9,45,1,7,0.642684729316485
"1149",1491629097,1,1,4,1,3,10,6,6,6,7,2,27,4,4,0.486866505060081
"1150",1154689646,1,5,4,5,5,20,11,8,9,11,9,48,7,8,0.161255914835654
"1151",1490595137,4,1,2,1,2,10,7,7,2,2,1,19,7,8,0.161255914835654
"1152",1713172010,2,3,3,3,3,14,9,9,5,6,6,35,1,5,0.642684729316485
"1153",1518511147,3,3,3,3,4,16,2,3,2,3,2,12,5,6,1.12411354379732
"1154",1491775552,1,2,1,1,2,7,9,7,11,6,4,37,2,6,1.36482795103773
"1155",1575941202,1,2,2,1,1,7,7,10,10,6,6,39,2,6,0.0384915671430424
"1156",1490755178,3,3,3,3,3,15,6,6,6,6,6,30,3,2,-1.20805422690819
"1157",1536841160,1,1,4,2,4,12,8,8,8,6,6,36,3,4,-1.05223600265178
"1158",1490581516,1,4,1,1,4,11,8,11,8,10,11,48,2,6,-0.428963105626168
"1159",1491207352,4,4,4,4,4,20,5,5,3,4,4,21,2,2,-1.05223600265178
"1160",1490839719,4,2,2,2,3,13,7,6,6,6,6,31,4,5,-0.0654843506931415
"1161",1702272740,1,1,1,1,1,5,6,6,3,6,6,27,2,6,1.47074229022351
"1162",1490806320,1,1,1,1,1,5,9,8,7,6,5,35,9,6,0.642684729316485
"1163",1491730582,4,4,4,1,4,17,9,9,9,9,9,45,9,6,0.8833991365569
"1164",1491520992,2,2,3,2,3,12,4,4,6,4,5,23,1,5,-1.20805422690819
"1165",1490686131,2,5,3,2,4,16,11,8,7,6,9,41,9,7,-0.117326657113361
"1166",1651066788,4,4,3,4,1,16,10,11,10,6,2,39,5,5,-1.20805422690819
"1167",1544124845,5,3,3,3,4,18,11,6,6,6,6,35,10,8,0.175230056547274
"1168",1331684566,2,3,3,3,3,14,6,6,6,7,6,31,3,2,-0.363146657494329
"1169",1490844324,3,4,3,4,4,18,8,7,7,6,9,37,1,8,-0.688757247718756
"1170",1490713965,1,1,1,1,1,5,6,7,4,6,7,30,3,2,1.47074229022351
"1171",1433084184,3,2,1,1,1,8,9,9,5,4,3,30,5,4,0.642684729316485
"1172",1511226724,3,4,3,3,2,15,7,8,8,7,8,38,7,5,0.642684729316485
"1173",1491779757,1,1,3,1,4,10,11,11,7,7,7,43,7,5,-1.20805422690819
"1174",1491174392,2,3,2,2,3,12,10,8,9,6,7,40,3,6,0.246152097819666
"1175",1490660130,3,3,2,2,4,14,6,6,6,6,6,30,3,4,0.161255914835654
"1176",1490733127,4,2,4,1,2,13,7,5,5,7,7,31,3,6,-1.20805422690819
"1177",1491049959,4,3,3,3,5,18,11,11,9,9,11,51,1,2,0.0384915671430424
"1178",1491512531,1,1,3,1,1,7,9,6,2,1,1,19,5,8,1.36482795103773
"1179",1596927482,3,3,3,4,4,17,5,7,3,4,5,24,2,4,-0.428963105626168
"1180",1491583654,1,1,3,3,3,11,6,5,6,6,6,29,10,8,0.401970322076069
"1181",1491492806,2,3,3,2,4,14,6,7,8,9,8,38,4,6,1.47074229022351
"1182",1490688973,2,1,1,1,1,6,9,8,4,6,7,34,10,8,0.486866505060081
"1183",1332133298,4,3,2,2,4,15,6,6,7,5,5,29,1,3,0.401970322076069
"1184",1491311255,2,3,3,2,3,13,8,7,7,8,6,36,7,6,-0.740599554138976
"1185",1453173243,4,5,4,4,5,22,7,9,8,9,10,43,3,2,-0.117326657113361
"1186",1490726189,1,1,1,1,1,5,8,8,5,3,7,31,4,8,0.161255914835654
"1187",1490716321,1,2,2,1,2,8,7,7,7,6,6,33,5,8,0.8833991365569
"1188",1513589423,1,5,5,4,5,20,3,6,4,2,2,17,7,6,0.8833991365569
"1189",1491519073,1,1,1,1,1,5,9,7,10,3,6,35,1,7,0.656658871028104
"1190",1490732850,2,2,2,1,1,8,3,8,5,2,3,21,4,6,1.47074229022351
"1191",1574827785,4,2,4,2,2,14,4,9,5,4,8,30,1,2,-0.117326657113361
"1192",1490580247,3,3,4,4,4,18,8,8,9,10,8,43,6,6,-0.377120799205949
"1193",1491579650,1,4,4,1,4,14,7,7,7,6,6,33,4,4,-0.117326657113361
"1194",1491523686,1,1,1,1,1,5,11,9,10,9,11,50,3,4,0.104308015274882
"1195",1662243452,2,1,1,1,2,7,4,6,6,5,6,27,6,3,0.0384915671430424
"1196",1491778986,1,1,1,1,1,5,11,9,4,4,8,36,3,8,1.47074229022351
"1197",1490802007,3,3,3,3,3,15,6,6,6,6,6,30,4,6,0.0384915671430424
"1198",1490586423,1,1,3,1,4,10,9,8,8,7,6,38,9,6,-1.20805422690819
"1199",1491699898,3,5,5,2,4,19,10,9,9,8,10,46,5,6,-0.117326657113361
"1200",1491639789,1,1,3,1,1,7,7,6,5,3,3,24,1,5,1.47074229022351
"1201",1491724249,2,2,2,4,1,11,11,10,11,11,11,54,4,4,0.175230056547274
"1202",1491518845,2,5,4,2,2,15,4,8,2,3,4,21,2,3,-1.20805422690819
"1203",1490672089,1,1,1,1,1,5,8,9,8,6,7,38,4,6,-0.740599554138976
"1204",1419478641,1,4,4,4,5,18,10,10,7,6,6,39,2,3,-1.20805422690819
"1205",1582574633,1,1,1,1,4,8,9,9,7,3,7,35,2,5,0.161255914835654
"1206",1491533579,1,1,2,1,3,8,11,9,7,6,6,39,10,5,0.175230056547274
"1207",1490563908,1,1,1,1,1,5,6,9,10,8,7,40,10,8,1.47074229022351
"1208",1491489028,4,3,3,3,3,16,7,9,8,8,8,40,3,6,-1.20805422690819
"1209",1490636192,3,3,3,3,3,15,6,4,6,6,6,28,5,6,-1.20805422690819
"1210",1491496611,3,3,3,3,3,15,6,6,6,6,6,30,5,2,1.47074229022351
"1211",1491518731,3,3,4,4,3,17,6,9,9,8,9,41,5,6,-0.117326657113361
"1212",1490605364,1,1,1,1,1,5,6,8,6,6,2,28,5,8,1.47074229022351
"1213",1557362974,2,2,3,1,4,12,7,11,3,2,2,25,5,6,-0.844575471975159
"1214",1490720218,1,1,2,1,2,7,6,7,7,7,7,34,5,6,0.642684729316485
"1215",1491566048,1,1,1,1,1,5,6,6,4,4,4,24,5,4,-1.20805422690819
"1216",1490720028,2,2,2,2,3,11,7,7,7,7,7,35,5,8,-0.117326657113361
"1217",1491753810,1,2,3,1,1,8,6,11,8,6,8,39,8,7,-0.306198757933557
"1218",1491221364,1,5,2,3,5,16,8,11,6,7,9,41,2,4,-0.740599554138976
"1219",1490691577,5,5,5,5,5,25,10,10,9,10,10,49,5,5,0.8833991365569
"1220",1491529719,1,5,4,5,4,19,8,10,10,9,11,48,5,2,-0.740599554138976
"1221",1490729736,1,4,3,2,2,12,7,10,7,6,11,41,5,4,0.642684729316485
"1222",1677828627,4,4,4,4,5,21,5,6,6,6,6,29,5,7,0.8833991365569
"1223",1491074719,1,2,3,3,3,12,8,6,7,7,8,36,5,6,0.00543769057925059
"1224",1491518562,4,4,3,3,3,17,5,5,8,6,7,31,5,6,0.00543769057925059
"1225",1491516498,4,4,4,4,3,19,7,7,6,6,5,31,5,3,-0.740599554138976
"1226",1694077017,1,1,1,1,3,7,11,11,11,11,11,55,5,4,-1.20805422690819
"1227",1491538858,1,1,1,1,4,8,8,8,8,8,8,40,5,5,-0.306198757933557
"1228",1608336283,2,3,2,3,1,11,10,9,9,8,11,47,5,7,-1.08528987921557
"1229",1491483367,5,5,5,5,5,25,6,11,2,6,2,27,5,8,-1.20805422690819
"1230",1491718008,2,1,1,1,1,6,6,11,6,6,6,35,1,5,0.8833991365569
"1231",1490580310,2,2,2,2,3,11,9,9,10,8,8,44,5,6,1.47074229022351
"1232",1490957487,3,2,4,1,1,11,10,10,9,3,9,41,5,4,-1.20805422690819
"1233",1491771695,1,3,2,1,2,9,8,9,4,5,6,32,5,8,0.246152097819666
"1234",1491384362,4,2,2,2,4,14,8,9,7,8,8,40,5,6,-0.428963105626168
"1235",1491518061,1,1,1,1,2,6,9,6,8,6,3,32,5,5,-0.117326657113361
"1236",1490725594,4,4,4,4,4,20,7,9,10,9,10,45,5,8,0.0384915671430424
"1237",1149112329,1,3,3,2,3,12,11,6,3,6,7,33,5,6,-0.929471654959171
"1238",1665427443,4,4,4,4,5,21,7,8,8,7,7,37,5,6,-1.20805422690819
"1239",1491332036,2,2,2,2,2,10,11,11,11,11,6,50,5,2,-0.117326657113361
"1240",1490721541,1,1,1,1,1,5,8,9,7,8,7,39,5,6,-1.20805422690819
"1241",1491522294,3,2,3,1,1,10,3,7,8,2,6,26,5,8,0.0384915671430424
"1242",1491399409,1,1,3,1,1,7,8,11,8,7,9,43,5,8,0.401970322076069
"1243",1491518946,2,2,2,2,2,10,6,6,6,6,6,30,5,4,0.642684729316485
"1244",1491639348,3,3,3,3,3,15,6,6,6,6,6,30,5,2,-1.20805422690819
"1245",1530373758,3,3,3,3,3,15,6,6,6,6,6,30,5,8,-1.05223600265178
"1246",1490730351,1,1,1,1,5,9,9,8,8,8,9,42,5,8,0.175230056547274
"1247",1199726413,1,2,2,1,3,9,10,9,8,9,10,46,5,2,-0.617835206446364
"1248",1640218455,1,1,1,1,4,8,6,9,6,6,8,35,5,8,-1.20805422690819
"1249",1439119662,2,4,4,2,4,16,10,10,7,7,7,41,5,2,-0.306198757933557
"1250",1490602716,1,1,1,1,4,8,11,10,11,11,11,54,5,2,1.12411354379732
"1251",1490708602,4,1,1,1,1,8,7,7,8,2,2,26,5,8,0.401970322076069
"1252",1490724413,1,1,1,1,1,5,6,11,9,6,11,43,10,5,0.8833991365569
"1253",1490696389,4,1,1,1,1,8,6,6,6,6,6,30,5,6,1.47074229022351
"1254",1491292614,3,4,3,3,3,16,6,7,7,7,7,34,10,5,-0.688757247718756
"1255",1490716175,1,2,1,1,1,6,8,10,9,6,10,43,6,8,1.47074229022351
"1256",1340368719,1,4,1,1,4,11,11,10,10,10,11,52,5,8,-1.20805422690819
"1257",1490611533,1,1,1,1,2,6,2,10,7,2,2,23,5,6,1.36482795103773
"1258",1349986472,1,3,2,1,1,8,8,10,10,10,10,48,5,7,0.401970322076069
"1259",1491482599,4,3,3,3,3,16,9,8,6,5,4,32,5,2,1.12411354379732
"1260",1491518374,4,2,1,1,1,9,10,7,9,8,9,43,5,8,1.36482795103773
"1261",1490756097,1,3,3,2,2,11,7,8,6,6,8,35,5,5,-0.428963105626168
"1262",1490702868,1,1,3,1,2,8,6,8,4,2,3,23,5,4,0.8833991365569
"1263",1490627533,2,2,2,1,3,10,8,6,6,6,6,32,5,6,0.0384915671430424
"1264",1652887518,3,4,3,4,1,15,11,9,7,7,6,40,5,4,1.12411354379732
"1265",1184564954,3,2,3,2,3,13,7,9,11,7,10,44,5,8,0.161255914835654
"1266",1490982551,3,2,3,2,3,13,5,7,7,5,6,30,5,6,1.47074229022351
"1267",1491526602,3,1,2,2,2,10,11,11,11,11,11,55,5,7,0.642684729316485
"1268",1490624014,1,1,1,1,1,5,7,7,6,4,1,25,5,6,0.0384915671430424
"1269",1711928392,2,5,3,4,2,16,11,9,4,1,2,27,5,4,0.8833991365569
"1270",1491653117,3,2,2,2,3,12,3,3,3,6,7,22,5,5,1.36482795103773
"1271",1490739169,3,3,4,3,4,17,11,11,8,8,11,49,5,8,-1.20805422690819
"1272",1490575352,3,2,1,1,2,9,5,7,4,5,5,26,5,7,0.0384915671430424
"1273",1490761273,1,3,3,1,2,10,11,9,7,7,11,45,5,6,1.47074229022351
"1274",1520660966,2,3,2,2,2,11,7,10,10,10,10,47,5,6,0.161255914835654
"1275",1491264011,4,1,3,1,1,10,10,9,1,6,4,30,5,5,0.380014720428688
"1276",1604591497,2,2,3,1,3,11,7,11,7,6,7,38,5,8,1.47074229022351
"1277",1490691366,1,3,2,3,1,10,11,8,4,4,3,30,5,7,-0.117326657113361
"1278",1650768172,1,1,1,1,2,6,6,9,2,6,6,29,5,8,-1.20805422690819
"1279",1391014495,1,1,3,1,1,7,7,8,8,8,8,39,5,6,1.47074229022351
"1280",1491744287,3,4,4,4,4,19,10,9,8,8,8,43,5,5,-1.20805422690819
"1281",1491486053,1,1,1,1,1,5,6,9,2,6,7,30,5,6,0.0384915671430424
"1282",1491779207,1,2,2,1,3,9,2,4,8,6,2,22,5,8,-0.306198757933557
"1283",1490591959,2,4,3,2,4,15,8,10,10,6,8,42,5,8,0.0384915671430424
"1284",1490571285,1,2,2,2,4,11,6,6,6,6,6,30,5,7,0.175230056547274
"1285",1490692023,4,2,2,1,2,11,10,10,9,9,9,47,5,5,-0.117326657113361
"1286",1144647665,1,1,1,1,1,5,10,9,7,6,6,38,5,6,0.0384915671430424
"1287",1490752141,4,3,3,2,5,17,8,10,9,8,10,45,5,7,-1.20805422690819
"1288",1491085344,1,2,2,1,2,8,9,9,8,8,9,43,5,6,0.0384915671430424
"1289",1491488164,3,1,3,1,1,9,11,11,7,8,11,48,5,4,-1.20805422690819
"1290",1687491682,1,1,1,1,1,5,11,10,10,10,9,50,5,6,-0.740599554138976
"1291",1624841554,1,1,1,1,1,5,8,9,7,4,4,32,5,6,-0.428963105626168
"1292",1490573742,1,3,2,2,2,10,6,7,5,3,3,24,5,2,1.47074229022351
"1293",1491533917,1,1,1,1,3,7,10,9,2,2,3,26,5,7,1.47074229022351
"1294",1490730993,1,3,4,2,4,14,7,8,8,7,9,39,5,5,0.401970322076069
"1295",1491712712,2,3,4,1,1,11,9,10,7,3,6,35,5,5,-1.20805422690819
"1296",1607473239,1,4,1,1,1,8,5,8,7,8,10,38,5,4,-0.136406391965533
"1297",1490708115,1,1,1,1,1,5,8,5,6,3,7,29,5,6,0.8833991365569
"1298",1714178223,1,4,3,1,3,12,11,9,3,1,1,25,5,4,0.0384915671430424
"1299",1490714574,4,2,1,1,1,9,6,3,9,9,9,36,5,7,1.47074229022351
"1300",1652811979,4,4,3,1,2,14,11,11,10,11,6,49,5,5,0.0384915671430424
"1301",1490578229,1,2,3,1,4,11,9,8,10,9,9,45,5,6,0.486866505060081
"1302",1378602604,3,5,4,4,4,20,11,8,9,9,9,46,5,2,-0.428963105626168
"1303",1490711943,2,4,2,2,2,12,7,10,8,9,10,44,5,7,0.161255914835654
"1304",1490748883,4,2,3,4,3,16,8,6,3,7,9,33,5,6,0.175230056547274
"1305",1491622440,1,1,5,1,5,13,11,11,11,6,11,50,5,6,-1.20805422690819
"1306",1655304718,2,3,4,3,4,16,9,9,7,6,9,40,5,4,-1.20805422690819
"1307",1340460790,3,1,1,1,1,7,3,9,5,6,3,26,5,8,0.8833991365569
"1308",1531813100,1,3,4,3,2,13,7,7,7,5,7,33,5,6,-1.20805422690819
"1309",1490573916,4,2,4,2,4,16,7,8,9,8,9,41,5,3,-1.20805422690819
"1310",1490711695,1,2,2,2,4,11,11,11,8,8,10,48,5,4,-1.20805422690819
"1311",1490602216,1,1,1,1,1,5,9,10,6,7,7,39,5,7,-0.117326657113361
"1312",1490751110,3,2,2,2,3,12,4,7,7,6,4,28,5,5,0.246152097819666
"1313",1491545683,2,2,2,1,2,9,7,6,7,6,5,31,5,6,-1.20805422690819
"1314",1443040489,4,4,4,3,2,17,4,5,4,4,6,23,5,6,1.12411354379732
"1315",1295068647,2,3,1,1,2,9,7,9,4,2,5,27,2,6,0.161255914835654
"1316",1490756070,3,3,3,3,3,15,6,6,6,6,6,30,5,4,-1.05223600265178
"1317",1708098006,1,2,2,1,1,7,9,6,6,4,4,29,5,5,0.0384915671430424
"1318",1490714004,1,1,1,1,2,6,11,11,11,11,11,55,5,6,0.401970322076069
"1319",1491492537,2,3,2,1,1,9,9,7,2,2,7,27,5,4,0.401970322076069
"1320",1491380667,3,3,3,1,3,13,6,6,7,6,6,31,2,6,1.47074229022351
"1321",1491733096,1,2,2,1,4,10,9,10,7,6,9,41,5,8,-0.117326657113361
"1322",1491505805,1,1,2,1,2,7,10,9,9,7,7,42,5,2,0.642684729316485
"1323",1580219599,2,2,1,1,2,8,7,8,5,4,6,30,5,6,0.642684729316485
"1324",1580432962,2,3,3,1,4,13,9,10,6,7,7,39,5,8,0.161255914835654
"1325",1491513787,1,2,3,3,4,13,9,7,7,6,6,35,5,8,-0.428963105626168
"1326",1491741680,1,4,3,1,3,12,8,8,2,2,1,21,5,4,0.0384915671430424
"1327",1490569103,4,2,3,1,2,12,9,6,7,9,7,38,5,5,-0.740599554138976
"1328",1491639495,3,3,4,2,4,16,6,7,7,6,6,32,5,4,0.0384915671430424
"1329",1490712629,1,4,4,1,4,14,6,8,1,1,4,20,5,6,0.161255914835654
"1330",1491528428,1,3,3,3,2,12,7,7,6,6,8,34,5,8,0.0384915671430424
"1331",1490582256,2,3,4,2,4,15,11,11,9,6,6,43,5,6,-1.20805422690819
"1332",1490595880,1,1,5,1,4,12,8,8,9,3,3,31,5,4,0.642684729316485
"1333",1490648307,3,3,2,2,2,12,8,6,2,3,6,25,5,7,0.642684729316485
"1334",1490723434,1,1,1,1,1,5,6,6,6,3,3,24,5,6,0.161255914835654
"1335",1490574899,1,3,1,1,3,9,7,7,6,6,1,27,5,7,0.161255914835654
"1336",1491503024,3,2,2,2,2,11,9,9,9,9,9,45,5,6,0.0384915671430424
"1337",1640249273,1,3,3,1,3,11,9,10,7,2,5,33,5,2,-1.20805422690819
"1338",1491374763,1,1,1,1,1,5,6,11,9,6,2,34,5,8,1.47074229022351
"1339",1490596683,1,4,3,1,1,10,3,7,5,2,2,19,5,2,0.0384915671430424
"1340",1580402763,3,4,4,2,2,15,7,9,7,4,3,30,5,6,0.968295319540912
"1341",1491519832,3,1,2,2,3,11,3,3,3,2,2,13,5,7,1.36482795103773
"1342",1438860109,1,2,1,1,3,8,5,7,7,6,5,30,5,7,0.642684729316485
"1343",1490804829,5,5,5,5,5,25,11,11,6,6,11,45,5,8,-1.20805422690819
"1344",1567390158,5,5,5,5,5,25,11,11,11,11,11,55,5,2,-1.20805422690819
"1345",1259534633,2,2,1,1,2,8,3,7,4,2,3,19,5,6,1.47074229022351
"1346",1454146138,1,1,1,1,1,5,6,10,6,7,7,36,5,4,1.12411354379732
"1347",1491638999,1,2,2,1,3,9,11,10,7,6,7,41,5,5,0.8833991365569
"1348",1490684270,4,1,1,1,3,10,7,8,4,3,5,27,5,8,-0.0654843506931415
"1349",1490752526,2,2,2,1,4,11,11,11,11,11,11,55,5,6,0.00543769057925059
"1350",1491782056,3,2,2,2,1,10,8,7,9,7,7,38,5,6,1.47074229022351
"1351",1491755501,1,1,1,1,1,5,9,9,9,9,9,45,5,5,0.642684729316485
"1352",1490570547,2,2,1,1,1,7,8,4,3,4,3,22,5,6,-0.117326657113361
"1353",1490712712,1,3,3,1,3,11,6,6,6,6,6,30,5,7,0.401970322076069
"1354",1304328922,1,1,1,1,5,9,11,11,11,11,11,55,5,6,0.642684729316485
"1355",1634449326,1,1,1,1,1,5,4,9,5,3,1,22,5,6,1.47074229022351
"1356",1491729837,2,2,1,1,1,7,7,7,3,2,6,25,5,8,1.12411354379732
"1357",1388475765,3,2,3,1,2,11,7,5,6,4,7,29,5,6,-0.136406391965533
"1358",1490618231,1,1,1,1,5,9,5,8,6,6,6,31,5,5,-0.117326657113361
"1359",1264552964,4,3,3,2,2,14,7,6,5,6,6,30,5,4,-0.740599554138976
"1360",1198526853,2,3,3,3,2,13,3,3,3,5,4,18,5,4,-1.20805422690819
"1361",1491526318,1,1,2,1,2,7,10,11,4,6,9,40,5,5,0.401970322076069
"1362",1491759593,1,1,1,1,1,5,10,10,2,6,8,36,5,5,1.47074229022351
"1363",1491516934,1,1,1,1,2,6,8,8,7,5,6,34,5,8,0.486866505060081
"1364",1491776407,3,3,3,3,5,17,11,11,11,11,11,55,5,2,-1.20805422690819
"1365",1491731652,2,3,2,2,2,11,6,6,5,6,6,29,5,2,1.47074229022351
"1366",1491494469,3,3,3,3,3,15,8,7,7,8,8,38,8,7,0.727580912300496
"1367",1491491544,1,3,3,1,3,11,5,4,6,5,7,27,5,8,0.0384915671430424
"1368",1490562908,1,4,2,2,4,13,8,8,11,9,7,43,5,3,0.0384915671430424
"1369",1491506225,1,1,4,1,4,11,11,11,11,6,9,48,5,6,-1.20805422690819
"1370",1490876955,4,4,3,2,2,15,6,7,7,7,8,35,3,8,1.36482795103773
"1371",1491495295,4,5,5,2,5,21,11,11,11,11,11,55,5,8,-0.428963105626168
"1372",1491421111,1,1,3,1,3,9,11,11,11,11,11,55,5,5,-1.20805422690819
"1373",1263789892,4,2,2,1,1,10,6,10,7,6,7,36,5,5,-1.20805422690819
"1374",1491532905,1,1,1,1,3,7,6,8,2,2,6,24,5,6,0.0384915671430424
"1375",1491480308,1,3,3,1,3,11,7,8,7,7,7,36,5,6,0.401970322076069
"1376",1491770897,1,1,1,1,2,6,7,7,5,6,6,31,5,8,0.0384915671430424
"1377",1421327621,1,1,1,1,2,6,6,7,7,7,7,34,5,4,0.401970322076069
"1378",1275366413,1,1,1,1,1,5,8,8,9,6,6,37,5,6,0.161255914835654
"1379",1491764557,4,4,3,2,4,17,10,11,11,11,11,54,5,6,-1.20805422690819
"1380",1490589391,3,2,3,2,3,13,9,9,9,9,9,45,5,5,0.0384915671430424
"1381",1491061122,3,5,5,5,5,23,11,11,11,11,11,55,5,2,-1.20805422690819
"1382",1491605878,3,4,3,3,2,15,8,9,7,6,6,36,5,4,-1.20805422690819
"1383",1491024013,3,3,3,3,3,15,8,9,7,8,8,40,5,8,0.8833991365569
"1384",1491467006,3,3,3,3,3,15,6,7,8,6,5,32,5,2,1.36482795103773
"1385",1491505694,3,4,2,4,4,17,7,7,5,2,8,29,5,6,0.8833991365569
"1386",1647209888,4,2,4,4,3,17,2,3,5,3,5,18,5,5,-0.428963105626168
"1387",1490703481,1,1,1,1,1,5,7,7,7,5,4,30,5,7,0.161255914835654
"1388",1673849874,1,1,1,1,1,5,5,4,3,1,1,14,5,8,1.47074229022351
"1389",1442896733,3,4,5,1,5,18,10,9,6,6,6,37,5,2,-0.306198757933557
"1390",1608532643,1,1,1,1,1,5,7,9,7,9,8,40,5,8,0.0384915671430424
"1391",1491499042,3,1,3,1,1,9,11,6,7,10,11,45,5,8,1.47074229022351
"1392",1490702978,3,3,3,3,3,15,8,8,8,8,8,40,5,8,0.486866505060081
"1393",1260405219,1,1,1,1,3,7,6,6,6,6,6,30,5,6,1.36482795103773
"1394",1703394054,2,4,4,2,4,16,7,7,8,7,7,36,5,4,0.642684729316485
"1395",1520459675,5,5,3,2,4,19,9,9,9,7,6,40,5,3,-1.05223600265178
"1396",1490762173,4,4,4,2,4,18,11,9,10,6,6,42,5,3,-1.20805422690819
"1397",1560421476,1,4,1,1,1,8,11,4,3,2,2,22,5,7,1.36482795103773
"1398",1491524898,3,3,3,3,3,15,9,10,9,4,5,37,5,3,-1.20805422690819
"1399",1490715563,3,3,3,3,3,15,9,10,9,9,8,45,5,6,-1.05223600265178
"1400",1490762020,1,2,3,2,4,12,6,8,9,6,6,35,5,5,0.8833991365569
"1401",1670471236,1,2,3,1,4,11,8,9,3,6,7,33,5,2,-0.428963105626168
"1402",1491760615,1,1,3,1,2,8,9,10,3,3,3,28,5,7,-1.20805422690819
"1403",1491501355,1,5,4,3,5,18,9,8,7,7,7,38,5,5,0.0384915671430424
"1404",1490711540,4,5,4,3,3,19,7,9,8,9,8,41,6,7,0.897373278268519
"1405",1491524113,2,3,3,1,2,11,9,10,5,4,6,34,6,8,0.175230056547274
"1406",1629147926,1,4,3,4,3,15,6,11,11,6,6,40,5,2,0.00543769057925059
"1407",1315057253,1,1,3,1,3,9,8,9,7,7,9,40,8,2,0.161255914835654
"1408",1490803989,1,1,1,1,2,6,10,9,8,9,10,46,10,4,0.246152097819666
"1409",1490751870,1,1,1,1,1,5,11,1,1,1,1,15,10,8,0.0384915671430424
"1410",1490760156,3,4,3,3,4,17,7,7,7,7,7,35,8,6,-0.0654843506931415
"1411",1490713908,4,4,3,3,2,16,8,6,6,6,6,32,10,7,-0.117326657113361
"1412",1574545948,2,2,3,2,2,11,2,3,3,2,2,12,8,8,1.12411354379732
"1413",1491542569,4,2,2,2,2,12,11,8,7,5,5,36,8,4,1.36482795103773
"1414",1491637358,1,1,1,1,2,6,7,10,2,8,11,38,8,6,-0.617835206446364
"1415",1491496898,4,3,3,3,3,16,8,7,7,6,7,35,8,6,-0.0654843506931415
"1416",1490704485,1,4,3,2,4,14,8,10,9,8,8,43,9,5,-0.428963105626168
"1417",1585348559,3,3,3,3,3,15,6,6,6,6,6,30,6,6,-1.20805422690819
"1418",1491529906,3,4,3,3,3,16,6,6,6,6,6,30,10,3,-1.20805422690819
"1419",1490614048,5,4,5,5,5,24,10,11,6,10,10,47,10,2,0.0384915671430424
"1420",1700039216,2,2,2,2,2,10,9,9,8,8,8,42,8,3,0.00543769057925059
"1421",1490641074,3,3,3,3,3,15,6,6,6,6,6,30,10,6,-0.740599554138976
"1422",1490749234,3,3,3,2,3,14,6,6,6,6,6,30,10,5,-0.117326657113361
"1423",1490578636,1,1,1,1,1,5,7,8,4,6,7,32,10,5,1.36482795103773
"1424",1491548704,4,4,3,3,4,18,8,10,8,8,9,43,10,6,0.0384915671430424
"1425",1491742801,2,2,2,1,1,8,7,7,8,8,8,38,8,4,0.161255914835654
"1426",1706239908,1,1,1,1,1,5,9,9,9,6,7,40,6,3,0.161255914835654
"1427",1490746325,2,3,3,2,3,13,6,8,6,6,6,32,6,6,0.161255914835654
"1428",1491499353,1,1,1,1,3,7,8,7,7,5,6,33,6,8,0.246152097819666
"1429",1490597579,1,1,1,1,1,5,6,8,9,6,6,35,7,6,1.47074229022351
"1430",1712595243,3,4,4,4,5,20,8,10,7,3,10,38,10,7,-1.05223600265178
"1431",1491506650,2,4,4,1,4,15,7,5,8,3,3,26,10,3,-1.20805422690819
"1432",1491512430,1,1,1,1,1,5,9,5,9,6,9,38,9,8,1.12411354379732
"1433",1490801085,3,3,4,3,4,17,8,6,5,4,8,31,7,5,1.47074229022351
"1434",1491720765,1,1,1,1,1,5,11,11,11,8,8,49,10,3,0.0384915671430424
"1435",1491766723,1,1,1,1,1,5,8,10,7,6,9,40,8,6,-1.05223600265178
"1436",1491625492,1,1,1,1,1,5,9,10,7,7,6,39,10,8,-1.20805422690819
"1437",1674303017,3,4,5,4,5,21,8,7,7,5,6,33,9,5,-0.0654843506931415
"1438",1454432008,4,4,4,2,2,16,11,11,9,7,6,44,9,7,-0.117326657113361
"1439",1580061511,2,2,2,2,2,10,10,10,9,8,10,47,7,7,-1.05223600265178
"1440",1713726946,3,2,3,3,2,13,8,8,8,9,9,42,10,6,0.0384915671430424
"1441",1270740974,1,4,4,2,5,16,11,11,11,11,11,55,6,2,-1.20805422690819
"1442",1491502781,1,5,3,3,5,17,11,11,11,11,11,55,6,2,0.246152097819666
"1443",1491517921,2,4,3,2,4,15,11,11,9,8,10,49,9,4,0.401970322076069
"1444",1491508734,4,2,2,2,4,14,7,7,7,7,7,35,8,6,0.401970322076069
"1445",1490715666,2,2,3,2,3,12,9,10,8,8,10,45,8,2,0.00543769057925059
"1446",1714723815,4,5,4,4,4,21,8,10,10,3,5,36,7,6,-1.20805422690819
"1447",1706912121,1,2,2,4,4,13,8,9,6,6,7,36,4,3,0.161255914835654
"1448",1491394283,4,5,4,2,2,17,4,7,5,4,7,27,4,2,-0.740599554138976
"1449",1612011249,1,5,2,1,4,13,9,8,7,6,7,37,4,8,0.0384915671430424
"1450",1490962910,4,3,3,4,4,18,6,7,7,6,5,31,6,5,1.47074229022351
"1451",1490727334,1,1,3,1,1,7,9,9,9,9,9,45,6,7,0.0384915671430424
"1452",1491027361,3,1,1,1,1,7,2,8,7,3,3,23,9,7,0.642684729316485
"1453",1491510040,1,2,2,1,2,8,4,3,7,5,7,26,6,7,1.47074229022351
"1454",1491163377,1,4,4,2,5,16,9,9,11,9,11,49,6,6,-1.20805422690819
"1455",1490704281,2,3,2,2,2,11,7,8,5,6,4,30,4,5,-0.428963105626168
"1456",1616321769,1,1,1,1,1,5,9,10,10,10,10,49,5,8,-0.428963105626168
"1457",1337810125,4,4,4,4,4,20,9,9,9,7,7,41,4,3,0.0384915671430424
"1458",1490691550,2,2,2,2,2,10,7,5,5,5,5,27,10,5,-0.428963105626168
"1459",1491398720,2,2,2,1,3,10,9,9,9,9,9,45,10,6,0.246152097819666
"1460",1710557454,1,5,3,1,2,12,9,9,9,9,9,45,8,8,0.0384915671430424
"1461",1490732506,3,3,3,3,3,15,6,6,6,6,6,30,7,4,-1.20805422690819
"1462",1491521227,3,3,3,1,3,13,6,8,9,6,9,38,9,7,0.401970322076069
"1463",1645414167,4,4,3,4,4,19,7,7,4,8,8,34,6,2,0.00543769057925059
"1464",1689927268,4,4,5,4,4,21,8,7,7,6,6,34,8,6,-0.740599554138976
"1465",1490573387,2,2,2,2,2,10,7,10,8,8,8,41,9,6,0.642684729316485
"1466",1491600620,2,1,1,1,2,7,8,9,3,5,3,28,10,6,0.00543769057925059
"1467",1717387126,5,5,5,3,3,21,10,11,9,8,6,44,9,3,1.12411354379732
"1468",1491171419,3,3,2,3,3,14,6,6,6,6,6,30,8,6,0.175230056547274
"1469",1490674860,1,1,1,1,1,5,11,9,5,4,6,35,8,8,1.12411354379732
"1470",1491576680,4,4,3,3,3,17,7,7,6,6,7,33,5,6,0.8833991365569
"1471",1491740182,1,2,4,1,4,12,9,11,9,11,11,51,7,8,1.47074229022351
"1472",1709898529,4,4,3,2,4,17,7,10,6,7,7,37,8,2,-1.20805422690819
"1473",1695609483,4,2,2,1,2,11,8,9,8,9,9,43,9,2,0.727580912300496
"1474",1491094758,3,3,1,3,4,14,5,8,6,4,4,27,6,5,-1.20805422690819
"1475",1717829909,4,2,2,1,1,10,9,10,8,6,7,40,6,7,0.642684729316485
"1476",1491529859,4,5,2,2,4,17,7,6,9,6,11,39,2,5,-0.117326657113361
"1477",1491590790,3,3,3,3,3,15,6,5,5,3,2,21,7,4,-0.740599554138976
"1478",1653188971,2,2,1,1,3,9,10,7,9,6,6,38,9,6,0.401970322076069
"1479",1491530473,1,3,2,1,4,11,1,6,4,1,1,13,8,5,1.36482795103773
"1480",1715475030,3,4,4,3,3,17,11,11,11,11,11,55,6,6,-1.05223600265178
"1481",1491126454,1,4,2,1,3,11,7,6,6,5,7,31,10,5,1.47074229022351
"1482",1491502366,3,5,4,1,5,18,8,9,9,6,7,39,10,6,-0.117326657113361
"1483",1716766534,1,1,1,1,5,9,6,7,8,6,6,33,8,6,0.0384915671430424
"1484",1491543652,3,3,3,3,3,15,6,6,6,6,6,30,8,4,-1.05223600265178
"1485",1490714435,1,1,1,1,1,5,8,8,4,5,4,29,8,7,0.246152097819666
"1486",1709470129,3,4,4,3,4,18,8,8,8,7,7,38,8,2,-1.20805422690819
"1487",1700074209,4,4,5,1,3,17,9,8,8,6,6,37,6,6,0.246152097819666
"1488",1309955226,3,3,3,3,3,15,1,6,7,1,6,21,9,5,-0.117326657113361
"1489",1262670523,1,2,5,4,4,16,9,9,8,9,3,38,6,3,-1.20805422690819
"1490",1491753505,1,1,1,1,1,5,6,6,6,6,6,30,6,8,0.8833991365569
"1491",1654677711,2,3,4,3,2,14,5,3,9,10,8,35,8,5,-0.428963105626168
"1492",1490695926,4,1,3,1,5,14,3,8,6,3,5,25,8,3,0.175230056547274
"1493",1491381410,3,3,3,2,2,13,8,8,8,7,8,39,10,3,-0.117326657113361
"1494",1703405376,4,4,4,4,4,20,9,9,9,9,9,45,10,8,0.00543769057925059
"1495",1597000134,2,3,2,1,2,10,7,6,4,6,4,27,8,5,-1.20805422690819
"1496",1491112019,4,4,4,4,4,20,11,9,8,7,9,44,5,6,-1.20805422690819
"1497",1491274975,1,3,1,1,3,9,8,11,7,6,6,38,8,8,-1.20805422690819
"1498",1513636956,5,5,4,1,5,20,7,9,8,6,8,38,7,6,-0.428963105626168
"1499",1622883150,3,2,3,1,4,13,6,9,8,10,11,44,6,4,0.104308015274882
"1500",1490680184,2,3,4,4,3,16,4,5,6,6,7,28,9,2,0.415944463787689
"1501",1491504948,1,2,2,1,3,9,7,7,8,7,6,35,10,3,0.161255914835654
"1502",1653999080,2,3,2,1,3,11,9,7,8,6,5,35,5,3,-0.428963105626168
"1503",1249119753,3,3,3,3,3,15,6,6,6,6,6,30,6,6,-0.306198757933557
"1504",1491488536,4,4,4,4,4,20,7,7,6,7,7,34,5,4,1.47074229022351
"1505",1491719590,1,1,3,1,1,7,11,11,9,9,11,51,7,5,-0.306198757933557
"1506",1587410981,3,5,5,5,5,23,11,11,11,11,11,55,7,2,-0.117326657113361
"1507",1717495978,4,3,3,3,5,18,10,9,9,10,11,49,3,8,0.246152097819666
"1508",1491339068,3,3,4,3,2,15,9,5,6,7,8,35,10,4,-0.617835206446364
"1509",1491236776,1,1,4,3,1,10,9,7,6,2,2,26,9,2,-0.117326657113361
"1510",1446498451,1,2,1,1,5,10,9,10,4,2,2,27,8,6,-0.740599554138976
"1511",1490694365,2,4,4,2,2,14,7,7,7,9,9,39,9,4,0.161255914835654
"1512",1491746521,2,2,1,1,1,7,7,8,9,8,9,41,9,5,-0.428963105626168
"1513",1490622523,2,2,3,3,3,13,4,5,6,7,8,30,3,4,-0.428963105626168
"1514",1662891773,1,2,2,2,2,9,11,11,11,10,10,53,9,4,-1.20805422690819
"1515",1491531217,3,3,3,3,3,15,6,6,6,6,6,30,8,2,-0.929471654959171
"1516",1284595031,1,1,1,1,1,5,7,7,6,8,9,37,9,7,1.47074229022351
"1517",1490924552,4,3,3,4,5,19,8,7,6,7,6,34,5,5,0.246152097819666
"1518",1557049474,4,4,5,5,4,22,8,6,6,7,7,34,10,7,0.486866505060081
"1519",1490694322,3,2,3,1,3,12,8,8,6,3,3,28,4,6,1.12411354379732
"1520",1708384851,4,5,5,5,1,20,10,10,11,6,8,45,3,6,0.0384915671430424
"1521",1491218544,1,4,3,3,4,15,7,9,10,6,11,43,8,8,0.175230056547274
"1522",1490807537,1,1,1,1,4,8,8,10,6,6,6,36,8,4,0.642684729316485
"1523",1490894910,4,5,5,3,4,21,7,9,6,6,9,37,4,5,0.642684729316485
"1524",1660024894,1,1,1,1,1,5,11,11,9,7,6,44,7,4,-0.740599554138976
"1525",1491496015,1,1,3,2,3,10,9,10,8,9,8,44,9,8,-1.20805422690819
"1526",1582370962,3,5,3,4,3,18,7,9,8,6,6,36,9,3,-1.05223600265178
"1527",1478731892,5,4,2,3,3,17,9,9,8,9,6,41,9,3,1.47074229022351
"1528",1491594479,3,3,2,3,2,13,9,9,9,6,8,41,10,6,0.8833991365569
"1529",1491530786,1,1,1,1,2,6,6,11,11,6,8,42,5,3,-1.20805422690819
"1530",1491113130,2,2,2,2,3,11,7,8,5,6,6,32,5,4,-1.20805422690819
"1531",1491507866,1,4,4,2,5,16,5,9,5,6,5,30,5,5,0.0384915671430424
"1532",1491769827,1,2,2,1,1,7,7,9,6,6,6,34,4,8,-1.20805422690819
"1533",1410039276,1,1,1,1,1,5,6,6,6,6,6,30,8,4,-1.20805422690819
"1534",1534982592,1,1,2,3,4,11,7,8,9,10,10,44,8,4,0.161255914835654
"1535",1490720502,1,1,2,1,2,7,2,7,3,4,5,21,5,3,-1.20805422690819
"1536",1490853723,2,2,3,3,4,14,9,9,8,8,8,42,5,6,-0.117326657113361
"1537",1491322008,4,5,3,4,4,20,6,4,4,6,7,27,5,6,0.401970322076069
"1538",1490673599,1,4,4,1,4,14,9,9,7,7,7,39,3,6,1.36482795103773
"1539",1490620795,4,2,5,4,3,18,6,7,7,4,6,30,3,3,-1.20805422690819
"1540",1491498640,2,4,3,5,4,18,4,3,6,6,7,26,8,2,-1.05223600265178
"1541",1539017106,4,2,4,4,3,17,8,8,9,9,9,43,3,6,-0.448042840478341
"1542",1670034510,5,4,4,3,4,20,8,10,9,11,9,47,5,7,0.8833991365569
"1543",1583905963,1,1,2,1,1,6,9,9,8,5,7,38,7,7,-0.428963105626168
"1544",1166368019,1,1,1,1,1,5,8,6,6,6,8,34,5,6,1.47074229022351
"1545",1688997925,3,4,4,2,2,15,10,8,9,10,8,45,5,3,-0.306198757933557
"1546",1611990671,3,5,4,4,5,21,9,9,9,9,9,45,5,8,-0.0654843506931415
"1547",1572204795,1,1,1,1,1,5,9,9,11,10,8,47,5,4,0.0384915671430424
"1548",1491551462,3,2,2,1,3,11,4,6,6,3,6,25,5,6,0.0384915671430424
"1549",1714284317,3,5,4,5,5,22,8,11,11,11,10,51,5,8,0.401970322076069
"1550",1491779903,2,2,3,1,3,11,7,7,7,7,7,35,5,6,1.47074229022351
"1551",1684537242,1,2,3,2,2,10,11,9,10,11,11,52,5,6,1.47074229022351
"1552",1521977719,2,4,5,1,4,16,11,11,8,4,5,39,5,4,-0.428963105626168
"1553",1490601763,2,3,1,4,3,13,7,10,7,7,7,38,5,3,-1.20805422690819
"1554",1523809042,2,2,3,1,1,9,3,3,4,4,5,19,5,6,-1.20805422690819
"1555",1490610124,3,2,2,1,3,11,2,10,11,6,10,39,5,5,-0.428963105626168
"1556",1491151977,2,5,3,5,4,19,8,8,7,5,6,34,5,4,-1.20805422690819
"1557",1490750084,3,3,3,3,3,15,6,6,6,6,6,30,5,5,-1.20805422690819
"1558",1491172370,3,4,3,4,3,17,8,9,8,6,7,38,5,3,-1.05223600265178
"1559",1702674477,3,4,4,2,2,15,11,11,11,11,11,55,5,2,-1.20805422690819
"1560",1480333962,3,3,3,3,3,15,5,7,6,6,7,31,5,6,-0.428963105626168
"1561",1490750347,4,3,3,3,5,18,3,7,7,5,6,28,5,3,-1.05223600265178
"1562",1491129818,3,4,2,2,2,13,8,6,7,5,6,32,5,7,0.486866505060081
"1563",1591341087,4,3,3,2,3,15,9,9,8,7,6,39,5,4,-1.20805422690819
"1564",1579227606,2,5,5,5,5,22,6,7,7,7,6,33,5,4,-0.306198757933557
"1565",1453789169,3,4,3,1,5,16,7,9,9,6,7,38,5,8,0.175230056547274
"1566",1490748841,4,2,2,2,3,13,7,7,7,7,8,36,5,7,-0.740599554138976
"1567",1688959680,1,1,1,1,4,8,11,11,11,10,10,53,5,7,0.161255914835654
"1568",1706935799,1,1,1,1,1,5,6,6,6,6,6,30,5,2,0.0384915671430424
"1569",1530018043,2,2,2,2,2,10,7,6,7,6,7,33,5,6,0.642684729316485
"1570",1383057376,1,1,3,1,5,11,11,11,8,8,10,48,5,7,-0.603861064734744
"1571",1491753971,1,2,3,2,3,11,6,8,5,5,4,28,5,5,-1.05223600265178
"1572",1715459923,3,4,4,4,4,19,11,11,11,5,11,49,5,3,-0.740599554138976
"1573",1490737927,2,3,3,1,3,12,6,6,6,6,6,30,5,6,0.175230056547274
"1574",1713929660,3,4,3,4,4,18,7,8,8,8,7,38,5,2,-0.740599554138976
"1575",1715114759,4,5,3,4,5,21,6,3,7,8,5,29,5,7,1.47074229022351
"1576",1491492075,1,3,2,2,3,11,9,7,8,6,6,36,5,2,-1.20805422690819
"1577",1491634931,1,4,3,1,1,10,10,10,10,10,10,50,5,8,1.20900972678133
"1578",1491047274,3,4,4,3,4,18,8,9,10,9,10,46,5,5,-1.20805422690819
"1579",1548295445,5,5,5,5,5,25,11,9,9,8,6,43,5,6,-1.05223600265178
"1580",1541959910,2,4,3,2,4,15,6,8,8,6,6,34,5,4,0.161255914835654
"1581",1491546969,3,5,5,4,5,22,11,11,9,6,9,46,5,3,-0.428963105626168
"1582",1491606814,3,5,4,5,3,20,3,3,5,4,4,19,5,2,1.47074229022351
"1583",1644120649,4,3,3,2,4,16,9,9,6,8,8,40,5,3,0.161255914835654
"1584",1710997388,4,4,5,4,5,22,4,2,11,7,6,30,5,7,-1.05223600265178
"1585",1708573897,4,4,2,2,2,14,8,11,5,7,9,40,5,3,-1.20805422690819
"1586",1701305119,4,5,3,3,4,19,9,8,6,7,9,39,5,3,-1.20805422690819
"1587",1464164892,2,4,4,3,5,18,6,9,7,6,7,35,5,6,-0.428963105626168
"1588",1662892653,2,2,2,1,2,9,7,7,6,6,6,32,5,6,0.642684729316485
"1589",1698599751,1,5,5,2,5,18,11,9,11,8,4,43,5,6,-0.740599554138976
"1590",1708096986,3,2,1,1,1,8,11,9,7,5,2,34,5,7,0.401970322076069
"1591",1529903171,4,5,4,5,4,22,8,10,9,9,9,45,5,2,-1.20805422690819
"1592",1437737342,4,2,1,1,1,9,11,9,6,7,7,40,5,4,0.161255914835654
"1593",1490721606,1,4,1,2,5,13,8,10,7,7,8,40,5,2,-0.428963105626168
"1594",1707392639,1,4,4,4,2,15,9,7,9,6,8,39,5,7,-0.117326657113361
"1595",1491190355,5,5,5,5,5,25,11,6,11,6,6,40,5,8,-0.929471654959171
"1596",1491712608,2,4,4,1,4,15,11,9,9,9,9,47,5,2,0.0384915671430424
"1597",1491391626,4,4,4,4,4,20,9,9,9,9,9,45,8,6,0.0384915671430424
"1598",1491259371,4,3,1,2,2,12,11,11,8,9,11,50,6,8,0.401970322076069
"1599",1697847290,2,1,3,2,4,12,3,7,6,7,4,27,9,7,0.161255914835654
"1600",1491394612,1,3,4,1,3,12,7,8,6,7,5,33,8,6,-1.05223600265178
"1601",1710300030,1,4,5,5,5,20,11,11,5,7,10,44,10,2,-1.08528987921557
"1602",1416799351,2,4,3,1,2,12,11,7,8,6,5,37,8,5,0.642684729316485
"1603",1491713752,4,4,2,4,4,18,8,5,8,9,9,39,7,3,-1.20805422690819
"1604",1700906239,1,1,1,1,2,6,8,10,10,10,10,48,3,5,-0.117326657113361
"1605",1491656605,1,1,1,1,1,5,5,7,7,6,6,31,6,5,0.246152097819666
"1606",1705514331,3,2,2,4,3,14,5,5,2,3,5,20,6,2,-0.377120799205949
"1607",1564786511,4,4,4,3,3,18,6,8,6,6,6,32,9,6,1.12411354379732
"1608",1672369662,5,5,3,1,2,16,11,11,11,11,11,55,9,3,-0.448042840478341
"1609",1663498071,2,4,4,4,4,18,11,11,4,11,11,48,4,8,-0.0654843506931415
"1610",1717865425,4,3,4,3,5,19,7,10,8,8,9,42,7,2,1.47074229022351
"1611",1491503565,4,3,3,4,3,17,6,6,6,6,7,31,7,5,-1.20805422690819
"1612",1567374254,4,3,4,4,3,18,6,6,6,3,5,26,6,6,-0.740599554138976
"1613",1715984422,1,1,2,2,4,10,10,10,8,8,6,42,6,6,0.161255914835654
"1614",1560675276,3,5,5,5,5,23,6,11,11,11,11,50,9,8,-1.20805422690819
"1615",1491353664,1,3,3,3,4,14,8,7,10,8,6,39,5,6,0.224196496172284
"1616",1490758195,4,3,2,3,4,16,7,8,9,10,7,41,7,2,-1.20805422690819
"1617",1491742383,1,1,1,1,1,5,6,6,6,6,7,31,7,2,1.47074229022351
"1618",1491515276,1,2,2,3,3,11,8,10,9,9,9,45,9,2,0.0384915671430424
"1619",1412463396,4,4,4,4,5,21,11,9,11,8,11,50,5,5,-1.20805422690819
"1620",1587667025,1,1,1,1,1,5,11,7,8,8,6,40,7,6,1.47074229022351
"1621",1716822135,4,2,2,2,3,13,6,8,4,6,8,32,4,5,1.47074229022351
"1622",1491497726,1,1,1,1,3,7,10,8,8,8,8,42,4,6,0.161255914835654
"1623",1491754796,1,2,3,1,2,9,9,11,6,4,3,33,4,4,0.00543769057925059
"1624",1491086197,3,4,3,2,5,17,9,11,9,6,6,41,4,2,-0.740599554138976
"1625",1618349123,2,3,2,2,3,12,11,11,10,7,6,45,7,5,-0.740599554138976
"1626",1491733197,3,3,2,2,4,14,7,7,6,7,9,36,9,6,0.8833991365569
"1627",1491514692,2,3,2,2,3,12,6,11,6,11,11,45,9,4,-1.05223600265178
"1628",1517471193,4,4,3,2,4,17,9,11,8,8,8,44,10,3,-1.20805422690819
"1629",1490948344,5,4,5,4,4,22,10,8,9,10,9,46,10,8,0.246152097819666
"1630",1680646543,3,3,3,1,4,14,7,6,7,7,7,34,6,5,0.401970322076069
"1631",1490750250,1,3,3,3,4,14,4,10,7,7,6,34,7,2,0.0384915671430424
"1632",1490709922,2,3,1,1,1,8,5,6,7,6,5,29,7,5,0.486866505060081
"1633",1661629475,1,4,1,1,2,9,10,8,4,9,11,42,10,4,1.47074229022351
"1634",1491524402,1,4,3,3,5,16,7,6,6,6,7,32,10,3,-0.740599554138976
"1635",1567544888,5,5,4,1,5,20,11,9,9,6,7,42,8,3,0.00543769057925059
"1636",1662871554,2,3,3,2,3,13,10,8,7,6,8,39,1,4,0.401970322076069
"1637",1491486161,1,1,3,1,2,8,9,8,4,6,5,32,4,5,-0.428963105626168
"1638",1717399068,3,3,3,3,3,15,5,6,5,6,5,27,6,4,-0.740599554138976
"1639",1491713257,3,3,3,3,3,15,11,5,5,6,10,37,4,6,-1.20805422690819
"1640",1490728931,1,1,2,1,2,7,9,7,5,4,9,34,4,6,0.401970322076069
"1641",1409405588,3,2,1,2,2,10,4,3,3,4,2,16,2,5,1.0032876174543
"1642",1696028565,4,3,3,3,3,16,4,4,4,4,5,21,8,3,-1.20805422690819
"1643",1684678937,1,2,1,1,1,6,11,9,9,9,9,47,9,4,1.47074229022351
"1644",1718828589,1,3,3,3,2,12,8,9,10,8,10,45,7,6,-0.740599554138976
"1645",1491576278,1,2,1,1,3,8,10,10,7,6,6,39,3,8,-1.20805422690819
"1646",1491527589,2,2,3,2,3,12,8,7,7,6,6,34,5,6,0.0384915671430424
"1647",1705468209,1,1,1,1,1,5,11,9,9,5,7,41,7,6,0.161255914835654
"1648",1490753913,1,2,2,3,2,10,7,8,3,6,5,29,7,6,0.00543769057925059
"1649",1719336104,3,3,3,3,4,16,7,6,7,6,7,33,7,8,-0.740599554138976
"1650",1556826476,3,4,4,3,3,17,6,8,9,6,1,30,7,2,0.0384915671430424
"1651",1667838062,4,4,4,2,4,18,9,8,5,6,7,35,7,6,-0.428963105626168
"1652",1490575334,1,4,4,1,1,11,9,8,3,3,3,26,10,8,0.0384915671430424
"1653",1598355228,3,3,3,3,4,16,9,9,7,6,6,37,6,5,0.0384915671430424
"1654",1491243437,3,3,3,1,3,13,6,6,6,6,6,30,2,2,-0.428963105626168
"1655",1694400530,1,3,2,1,3,10,8,6,7,6,6,33,4,8,1.47074229022351
"1656",1491502156,3,3,4,2,2,14,4,5,6,7,6,28,4,4,0.161255914835654
"1657",1521651901,1,2,5,1,1,10,8,10,11,4,6,39,4,8,0.642684729316485
"1658",1404715426,3,4,2,4,4,17,7,5,6,6,6,30,4,5,-0.740599554138976
"1659",1490892325,1,1,1,1,4,8,6,6,6,6,6,30,9,2,-0.0654843506931415
"1660",1490752277,1,1,1,1,1,5,2,2,2,2,2,10,4,5,-0.377120799205949
"1661",1491519207,1,3,2,1,3,10,9,11,8,4,7,39,7,7,1.47074229022351
"1662",1491054319,1,5,3,4,5,18,9,11,10,1,1,32,5,2,1.12411354379732
"1663",1490722821,3,2,2,2,3,12,6,8,6,9,9,38,3,4,0.486866505060081
"1664",1490565450,1,1,2,1,4,9,7,9,8,8,8,40,3,6,0.0384915671430424
"1665",1491494125,3,2,2,3,3,13,6,6,6,6,6,30,6,5,0.0384915671430424
"1666",1490578506,3,1,1,1,4,10,9,10,10,9,10,48,9,6,0.401970322076069
"1667",1685016828,3,3,3,2,3,14,10,9,9,8,10,46,4,6,-1.08528987921557
"1668",1491520898,1,2,3,1,4,11,11,7,4,9,6,37,4,3,-0.448042840478341
"1669",1490943058,3,4,3,3,4,17,11,1,11,11,10,44,7,8,0.486866505060081
"1670",1490724813,3,3,3,3,3,15,6,6,6,6,6,30,3,6,0.401970322076069
"1671",1698664457,2,4,2,2,2,12,8,8,5,4,7,32,5,4,0.0384915671430424
"1672",1125529138,5,1,2,1,4,13,11,11,11,11,11,55,3,3,-0.117326657113361
"1673",1645698608,3,4,2,1,2,12,8,10,9,9,9,45,4,5,0.0384915671430424
"1674",1410205216,4,2,2,2,2,12,8,9,6,6,7,36,2,8,0.0384915671430424
"1675",1702435600,2,5,2,1,4,14,11,10,10,10,6,47,2,3,0.642684729316485
"1676",1490712220,5,3,2,1,4,15,7,7,7,7,7,35,10,4,0.0384915671430424
"1677",1491738578,2,3,4,2,3,14,11,11,2,1,1,26,9,8,0.246152097819666
"1678",1490721109,1,3,2,1,3,10,7,9,8,6,6,36,9,6,0.415944463787689
"1679",1687115405,1,1,3,1,3,9,6,7,11,7,7,38,9,8,-0.428963105626168
"1680",1491767299,1,4,3,1,4,13,7,9,7,6,7,36,8,6,0.161255914835654
"1681",1715975936,5,5,5,5,5,25,10,6,11,9,11,47,8,8,-0.428963105626168
"1682",1491751537,1,2,1,1,3,8,8,10,3,2,2,25,6,6,-1.20805422690819
"1683",1491259504,2,2,3,4,1,12,6,4,5,3,7,25,6,3,0.0384915671430424
"1684",1490720400,1,1,1,1,1,5,9,9,4,7,7,36,8,8,0.691651168941495
"1685",1491337223,4,5,5,4,5,23,11,6,6,8,9,40,2,4,1.47074229022351
"1686",1490578705,3,3,2,2,2,12,2,8,7,3,3,23,4,6,0.0384915671430424
"1687",1716464306,2,2,2,2,2,10,9,7,8,7,8,39,10,6,1.12411354379732
"1688",1626216991,4,3,3,2,3,15,7,4,7,6,7,31,10,6,-1.20805422690819
"1689",1668553209,1,1,1,1,1,5,10,8,9,8,7,42,2,4,-0.740599554138976
"1690",1491576927,2,2,2,2,4,12,7,8,7,7,6,35,5,4,-1.20805422690819
"1691",1490758324,2,4,2,1,4,13,6,6,6,6,6,30,7,2,1.47074229022351
"1692",1490804682,3,5,5,5,5,23,10,11,10,6,11,48,1,5,-1.20805422690819
"1693",1591078308,5,4,3,2,4,18,11,10,9,11,11,52,5,4,1.36482795103773
"1694",1468058897,1,2,4,4,4,15,8,9,11,7,6,41,2,6,0.8833991365569
"1695",1491561450,3,3,2,3,2,13,5,6,5,3,5,24,1,2,-1.20805422690819
"1696",1692327931,1,4,4,3,5,17,10,9,8,10,10,47,4,2,0.0384915671430424
"1697",1491055795,1,3,3,1,4,12,8,8,6,7,7,36,5,6,0.401970322076069
"1698",1454926102,2,4,3,4,4,17,9,10,5,4,3,31,4,4,-0.117326657113361
"1699",1685873877,4,4,4,4,5,21,10,9,10,9,10,48,5,7,-0.844575471975159
"1700",1491756228,4,5,5,4,4,22,7,9,8,7,9,40,5,6,0.0384915671430424
"1701",1567738599,3,4,4,4,5,20,9,10,6,6,8,39,5,2,0.0384915671430424
"1702",1491259996,4,1,1,1,1,8,11,11,11,11,11,55,3,6,-1.05223600265178
"1703",1491581754,3,3,3,3,3,15,6,6,6,6,6,30,3,6,-1.05223600265178
"1704",1691889779,1,1,1,1,1,5,1,6,2,1,2,12,7,7,0.274100381242905
"1705",1702401080,2,1,2,1,1,7,8,6,6,6,6,32,3,8,1.47074229022351
"1706",1582786765,1,5,4,2,4,16,8,9,7,7,10,41,10,4,0.401970322076069
"1707",1490564509,1,1,1,1,3,7,6,10,7,6,6,35,3,8,1.12411354379732
"1708",1700827045,2,1,1,2,2,8,11,11,9,10,11,52,10,2,1.47074229022351
"1709",1490750214,2,2,2,2,2,10,9,6,7,4,6,32,2,4,0.161255914835654
"1710",1697420487,4,4,2,4,4,18,5,10,9,8,10,42,4,6,-0.428963105626168
"1711",1709404680,3,2,4,5,5,19,6,9,5,5,6,31,2,5,-0.929471654959171
"1712",1490719281,1,1,1,1,1,5,11,11,11,6,8,47,6,8,1.47074229022351
"1713",1490609294,3,4,4,4,5,20,3,4,3,2,2,14,6,7,-0.0654843506931415
"1714",1490759997,2,2,3,3,3,13,7,6,8,7,7,35,7,7,-0.117326657113361
"1715",1491214698,2,3,4,4,4,17,8,9,8,7,8,40,5,2,-1.20805422690819
"1716",1711477863,1,1,3,1,3,9,7,9,9,9,10,44,5,4,0.246152097819666
"1717",1687320375,4,5,3,3,2,17,8,7,9,6,5,35,3,6,-0.117326657113361
"1718",1490613771,5,4,4,3,4,20,5,4,4,7,3,23,3,5,0.161255914835654
"1719",1627571588,4,2,3,4,3,16,8,9,6,4,5,32,6,6,0.161255914835654
"1720",1490703917,1,1,1,1,1,5,8,7,4,1,1,21,4,2,0.0384915671430424
"1721",1491604759,3,3,3,3,3,15,6,6,6,6,6,30,6,6,-0.428963105626168
"1722",1610113423,1,5,5,3,5,19,9,11,8,6,5,39,2,2,-0.207328433237925
"1723",1490969709,1,1,4,1,1,8,4,8,3,1,4,20,2,8,1.36482795103773
"1724",1371373541,2,2,2,2,4,12,9,8,7,7,7,38,6,6,1.47074229022351
"1725",1491551926,1,4,3,3,4,15,11,6,4,4,8,33,9,5,-0.117326657113361
"1726",1671942341,1,3,3,1,2,10,7,7,6,7,7,34,6,6,0.0384915671430424
"1727",1490716035,2,1,1,1,3,8,6,6,6,6,6,30,1,4,0.0384915671430424
"1728",1597898848,2,1,3,2,4,12,11,6,9,10,7,43,2,5,-1.20805422690819
"1729",1659625208,1,3,2,1,3,10,9,10,6,7,8,40,2,2,0.401970322076069
"1730",1627205369,3,4,5,4,4,20,5,11,3,8,11,38,2,2,-1.20805422690819
"1731",1662023761,5,5,5,5,3,23,11,11,7,6,5,40,2,6,-1.20805422690819
"1732",1491675191,3,4,4,4,5,20,8,6,8,8,8,38,4,6,-0.617835206446364
"1733",1573927760,4,5,5,4,5,23,8,11,5,5,5,34,7,6,-1.20805422690819
"1734",1644030829,2,3,3,3,3,14,8,9,7,9,9,42,2,4,0.161255914835654
"1735",1490570346,1,1,1,1,1,5,11,10,9,6,9,45,6,5,0.486866505060081
"1736",1491160444,3,4,4,4,4,19,8,6,5,5,5,29,4,7,0.246152097819666
"1737",1704316133,3,4,2,2,2,13,9,9,4,8,8,38,4,4,-0.428963105626168
"1738",1647517795,4,4,4,4,5,21,5,6,6,6,6,29,9,6,-1.20805422690819
"1739",1490682066,5,5,5,5,5,25,6,6,6,6,6,30,9,8,0.104308015274882
"1740",1713823171,1,1,4,1,1,8,3,5,1,1,1,11,6,3,1.47074229022351
"1741",1491506234,3,3,3,3,3,15,9,7,7,6,7,36,5,7,-1.20805422690819
"1742",1640880302,1,5,5,3,5,19,11,11,11,11,11,55,4,2,0.656658871028104
"1743",1491473511,2,1,1,1,1,6,11,10,8,6,6,41,2,6,0.00543769057925059
"1744",1490720158,2,2,2,2,2,10,5,9,7,3,8,32,5,8,-0.306198757933557
"1745",1546714578,5,5,5,5,5,25,10,9,8,9,8,44,5,8,-1.05223600265178
"1746",1490692583,1,1,1,1,1,5,11,7,3,8,5,34,8,5,0.0384915671430424
"1747",1219267444,3,5,4,4,3,19,6,4,9,8,6,33,9,5,0.0384915671430424
"1748",1490694951,4,5,5,5,4,23,10,10,10,10,10,50,8,8,-0.428963105626168
"1749",1150960988,1,4,2,1,4,12,11,6,7,4,4,32,5,7,-1.20805422690819
"1750",1637702378,3,3,3,3,4,16,7,9,6,9,8,39,3,5,-1.20805422690819
"1751",1694737419,4,5,4,4,4,21,11,11,11,11,10,54,3,6,0.175230056547274
"1752",1490715012,3,2,3,3,3,14,8,8,8,8,6,38,3,5,0.00543769057925059
"1753",1716324714,1,1,1,1,4,8,9,7,6,5,6,33,4,2,0.175230056547274
"1754",1715907983,2,2,2,1,5,12,8,8,8,7,7,38,5,5,1.47074229022351
"1755",1353094574,3,4,3,2,2,14,8,8,7,5,7,35,5,6,-0.428963105626168
"1756",1686655952,3,4,3,3,4,17,11,10,10,9,10,50,2,3,-0.740599554138976
"1757",1717386490,1,2,1,1,1,6,11,8,8,1,1,29,1,4,0.642684729316485
"1758",1491511710,2,4,4,3,4,17,6,9,5,4,4,28,1,2,-0.117326657113361
"1759",1491490772,4,4,3,3,3,17,9,11,7,6,8,41,8,6,0.968295319540912
"1760",1612436866,2,2,2,3,3,12,6,7,6,5,6,30,1,8,-0.306198757933557
"1761",1687948134,4,4,4,4,4,20,6,5,7,8,7,33,1,3,-0.136406391965533
"1762",1490604409,1,1,1,1,1,5,10,11,10,11,7,49,1,4,-0.428963105626168
"1763",1561801192,2,2,2,2,2,10,6,9,7,4,4,30,1,4,-0.428963105626168
"1764",1490600962,1,2,2,1,3,9,10,8,10,6,6,40,1,8,-0.428963105626168
"1765",1641806612,3,3,3,3,3,15,6,6,6,6,6,30,1,6,-1.20805422690819
"1766",1715376455,3,4,4,2,4,17,11,10,7,6,10,44,1,3,-0.428963105626168
"1767",1633896759,1,3,2,1,2,9,8,9,7,7,7,38,3,2,-1.20805422690819
"1768",1491772210,1,2,1,1,3,8,9,9,7,8,8,41,5,5,0.968295319540912
"1769",1490693452,2,5,4,4,5,20,4,6,6,3,9,28,7,2,-0.740599554138976
"1770",1491617924,4,4,4,2,4,18,8,9,7,8,8,40,7,6,-1.20805422690819
"1771",1490572393,1,1,1,1,1,5,10,9,8,8,9,44,3,4,-1.05223600265178
"1772",1261498584,3,1,1,1,3,9,10,9,7,7,6,39,3,8,0.00543769057925059
"1773",1539322443,1,4,2,4,3,14,6,9,4,2,2,23,1,2,0.00543769057925059
"1774",1687422520,1,4,4,1,5,15,11,11,8,8,8,46,7,8,-0.117326657113361
"1775",1490691401,1,1,1,1,1,5,5,5,2,4,1,17,1,8,0.246152097819666
"1776",1717294727,2,1,1,1,1,6,10,9,8,6,6,39,1,8,-0.740599554138976
"1777",1491100703,1,1,1,1,1,5,11,10,5,2,3,31,1,3,-0.363146657494329
"1778",1709011912,1,2,2,1,1,7,7,7,7,5,7,33,3,6,0.0384915671430424
"1779",1490908951,4,4,2,3,5,18,8,10,9,9,10,46,2,3,0.161255914835654
"1780",1712580225,1,3,3,3,5,15,9,8,10,10,9,46,1,6,0.486866505060081
"1781",1491506660,1,4,4,3,2,14,10,10,10,10,10,50,1,8,0.642684729316485
"1782",1491512345,3,3,4,3,3,16,7,8,7,6,5,33,1,8,0.0384915671430424
"1783",1703659277,2,1,1,1,4,9,8,8,9,7,10,42,1,6,0.642684729316485
"1784",1490690809,4,5,3,3,5,20,7,8,6,6,2,29,1,6,-0.428963105626168
"1785",1491522478,3,5,4,4,4,20,8,10,7,6,8,39,1,3,0.0384915671430424
"1786",1105315898,1,1,1,1,1,5,7,8,1,1,2,19,2,6,-0.740599554138976
"1787",1490634281,4,5,4,2,4,19,6,7,7,7,5,32,2,6,-0.306198757933557
"1788",1491776358,1,4,3,2,3,13,6,6,7,7,7,33,1,4,-0.740599554138976
"1789",1490751561,3,2,1,1,4,11,6,6,6,6,6,30,5,6,-0.740599554138976
"1790",1626856104,1,1,1,1,3,7,8,8,4,4,4,28,3,8,-0.428963105626168
"1791",1490586732,4,4,3,3,4,18,7,7,4,6,7,31,8,3,-0.688757247718756
"1792",1491048604,5,5,5,3,5,23,11,11,8,6,6,42,1,3,0.968295319540912
"1793",1554860104,4,2,3,2,2,13,9,9,8,7,9,42,2,2,0.642684729316485
"1794",1701818502,5,5,4,4,4,22,11,8,6,11,11,47,7,4,-1.20805422690819
"1795",1469837789,1,3,3,1,3,11,6,5,5,6,6,28,7,6,1.36482795103773
"1796",1491687199,3,3,3,3,3,15,6,6,6,6,6,30,1,5,1.47074229022351
"1797",1491263979,3,3,3,3,3,15,6,6,6,6,6,30,1,3,0.0384915671430424
"1798",1413190040,1,1,1,1,1,5,3,6,3,1,1,14,1,2,-0.117326657113361
"1799",1491748194,3,4,4,3,4,18,8,7,7,9,8,39,2,6,-1.20805422690819
"1800",1272665373,1,5,5,5,5,21,6,6,6,6,6,30,2,4,-1.20805422690819
"1801",1647079872,3,4,2,2,2,13,6,9,6,6,6,33,9,4,-1.20805422690819
"1802",1573690187,1,1,1,1,1,5,11,7,6,6,8,38,2,5,0.0384915671430424
"1803",1490689040,4,3,3,4,4,18,9,8,7,8,6,38,3,6,1.12411354379732
"1804",1490728716,1,1,1,1,1,5,7,7,7,5,5,31,1,7,0.642684729316485
"1805",1548709729,1,2,1,5,2,11,8,10,5,2,8,33,5,4,1.20900972678133
"1806",1491492802,4,3,3,3,3,16,6,6,6,6,6,30,2,6,-1.20805422690819
"1807",1699204016,1,3,3,1,2,10,9,10,6,6,6,37,2,4,-1.20805422690819
"1808",1717263611,3,2,3,2,5,15,8,6,4,3,4,25,2,7,-1.20805422690819
"1809",1491521323,3,3,3,2,2,13,7,6,6,6,6,31,3,5,-0.617835206446364
"1810",1602637768,2,4,4,4,5,19,11,11,6,6,9,43,4,2,1.12411354379732
"1811",1491587060,4,3,3,3,4,17,6,6,6,6,6,30,6,6,-1.20805422690819
"1812",1491515295,1,1,1,1,3,7,6,7,7,6,6,32,1,6,0.8833991365569
"1813",1320464889,3,2,3,3,3,14,6,5,8,9,6,34,2,6,-1.05223600265178
"1814",1582344549,1,3,3,1,3,11,11,11,11,9,11,53,4,2,0.0384915671430424
"1815",1663981210,5,4,4,3,4,20,6,7,4,8,8,33,3,2,-1.20805422690819
"1816",1689972953,4,4,4,1,5,18,2,2,3,3,6,16,4,4,-0.428963105626168
"1817",1491173845,3,3,3,3,3,15,6,6,7,8,8,35,4,4,-1.20805422690819
"1818",1383232355,2,4,2,2,4,14,7,10,8,5,4,34,7,7,-1.20805422690819
"1819",1491515202,1,3,3,3,3,13,8,7,10,8,7,40,7,2,-1.20805422690819
"1820",1491485763,1,3,4,3,3,14,8,8,7,8,8,39,6,4,1.12411354379732
"1821",1491745733,1,1,1,1,3,7,11,10,10,6,6,43,1,6,1.47074229022351
"1822",1639903678,3,3,3,3,3,15,6,6,6,6,6,30,5,3,-1.20805422690819
"1823",1490729983,3,3,3,2,2,13,4,9,7,11,11,42,1,4,-0.117326657113361
"1824",1431516163,3,4,4,3,3,17,9,8,7,7,8,39,1,5,-1.20805422690819
"1825",1520459801,3,4,2,1,4,14,8,7,6,2,2,25,5,5,1.12411354379732
"1826",1341817345,3,3,3,3,3,15,7,9,4,6,9,35,5,5,-1.20805422690819
"1827",1682300704,3,5,4,4,3,19,2,7,7,6,9,31,4,5,0.161255914835654
"1828",1490725639,3,3,3,3,3,15,6,6,6,6,6,30,2,2,-1.20805422690819
"1829",1698210402,1,1,2,1,4,9,4,9,7,3,3,26,4,2,-1.05223600265178
"1830",1491074086,1,2,2,1,2,8,7,8,11,6,6,38,3,6,0.175230056547274
"1831",1490593461,1,5,5,1,1,13,9,7,9,7,6,38,1,7,0.161255914835654
"1832",1491128874,4,4,4,2,4,18,6,8,8,9,6,37,1,2,0.161255914835654
"1833",1491027657,3,4,4,3,4,18,8,8,7,8,9,40,1,6,-1.20805422690819
"1834",1338026396,4,2,4,4,4,18,8,6,9,8,9,40,1,6,-0.688757247718756
"1835",1717872074,1,5,4,5,4,19,8,10,8,4,7,37,1,2,0.161255914835654
"1836",1694680402,1,4,2,1,4,12,9,11,9,8,9,46,1,8,-1.20805422690819
"1837",1491522730,4,4,2,2,4,16,9,9,8,7,7,40,1,6,0.0384915671430424
"1838",1443544681,3,4,4,3,2,16,10,11,7,7,8,43,3,6,-0.428963105626168
"1839",1490615454,1,1,1,1,3,7,10,10,7,6,7,40,1,4,-1.20805422690819
"1840",1490757526,1,3,3,3,3,13,6,6,6,6,6,30,1,7,-0.428963105626168
"1841",1529956958,1,4,3,3,3,14,8,6,7,6,9,36,1,5,0.415944463787689
"1842",1491700777,1,1,1,1,1,5,7,6,7,3,2,25,1,8,-1.20805422690819
"1843",1491713425,4,5,5,5,4,23,10,11,11,11,11,54,2,8,-0.740599554138976
"1844",1698615832,4,1,1,1,1,8,6,7,7,5,6,31,4,7,1.36482795103773
"1845",1529529822,1,1,1,1,1,5,9,9,1,6,1,26,5,8,0.161255914835654
"1846",1491540120,1,1,1,1,1,5,8,7,4,4,3,26,1,6,0.727580912300496
"1847",1491288321,3,2,2,2,2,11,3,3,8,8,9,31,3,8,0.8833991365569
"1848",1458155326,1,4,4,3,4,16,6,6,6,6,6,30,1,2,-1.20805422690819
"1849",1717621912,1,1,1,1,1,5,7,6,7,6,2,28,1,2,-1.20805422690819
"1850",1490725495,2,2,2,1,2,9,8,9,6,6,7,36,7,8,0.0384915671430424
"1851",1704925492,3,3,4,3,3,16,6,6,6,6,8,32,6,5,-1.20805422690819
"1852",1648957406,4,4,4,4,4,20,11,11,11,11,11,55,6,4,-1.20805422690819
"1853",1490734541,4,2,1,1,1,9,8,11,7,1,10,37,3,7,0.401970322076069
"1854",1490658380,5,4,4,5,4,22,7,7,6,6,8,34,1,6,-0.448042840478341
"1855",1491706999,1,5,4,3,5,18,6,6,6,6,6,30,6,6,-1.05223600265178
"1856",1716807844,4,4,4,3,4,19,8,8,8,8,8,40,1,3,-1.20805422690819
"1857",1696070849,5,2,4,3,3,17,5,3,2,2,1,13,6,2,1.47074229022351
"1858",1690628097,4,4,4,4,4,20,6,6,6,6,6,30,4,2,-0.117326657113361
"1859",1491590759,1,1,1,1,1,5,7,6,6,5,4,28,4,8,0.642684729316485
"1860",1490571014,1,1,1,1,1,5,2,4,3,1,1,11,3,8,1.47074229022351
"1861",1491113846,1,3,4,3,3,14,6,6,7,6,6,31,3,2,0.246152097819666
"1862",1490754966,1,4,2,2,4,13,9,10,2,2,7,30,1,4,1.36482795103773
"1863",1490727471,2,2,2,1,3,10,6,6,5,4,4,25,1,5,0.727580912300496
"1864",1491466806,2,3,2,1,3,11,6,8,8,5,5,32,1,2,-0.448042840478341
"1865",1623601720,1,1,2,1,1,6,6,9,6,6,1,28,5,8,0.161255914835654
"1866",1706931980,4,4,4,4,5,21,9,11,7,10,7,44,6,4,-0.428963105626168
"1867",1526807930,1,2,3,3,2,11,8,9,7,3,8,35,2,4,0.161255914835654
"1868",1361114044,4,4,4,4,4,20,6,6,6,6,6,30,2,2,0.415944463787689
"1869",1698611868,1,2,2,2,1,8,11,11,6,6,8,42,1,3,-1.20805422690819
"1870",1491502270,1,3,3,3,3,13,6,9,3,3,3,24,1,5,1.47074229022351
"1871",1490616112,1,1,1,1,1,5,2,6,3,1,1,13,1,4,0.104308015274882
"1872",1715873893,5,5,5,5,5,25,11,11,11,8,8,49,1,6,0.642684729316485
"1873",1710164712,2,5,5,5,4,21,6,6,6,6,6,30,2,4,-1.20805422690819
"1874",1581112287,4,5,4,4,3,20,6,8,8,6,8,36,3,6,-0.428963105626168
"1875",1490580378,1,1,1,1,1,5,10,7,7,5,6,35,4,7,0.401970322076069
"1876",1491542030,1,3,2,1,2,9,8,8,7,6,6,35,1,5,0.642684729316485
"1877",1490754532,3,3,2,1,1,10,7,8,5,6,5,31,1,6,0.642684729316485
"1878",1415188348,2,2,3,2,3,12,3,5,5,7,5,25,1,3,0.161255914835654
"1879",1491485181,1,3,2,1,3,10,6,9,11,9,11,46,1,2,-1.20805422690819
"1880",1449921457,2,3,3,2,2,12,7,7,8,8,8,38,1,6,0.00543769057925059
"1881",1491778139,1,1,1,1,1,5,8,7,7,3,6,31,1,8,1.47074229022351
"1882",1543666912,3,3,3,3,3,15,6,6,6,7,6,31,1,2,0.246152097819666
"1883",1490996410,2,4,4,4,2,16,7,8,5,5,6,31,1,5,-1.20805422690819
"1884",1491471498,1,1,1,1,1,5,6,6,6,6,6,30,4,5,-0.117326657113361
"1885",1491491084,3,3,3,3,3,15,6,6,6,6,6,30,3,6,-1.05223600265178
"1886",1545057666,5,5,1,1,5,17,6,6,6,6,6,30,7,7,-0.428963105626168
"1887",1286666562,4,4,3,4,4,19,5,4,4,5,3,21,4,7,0.401970322076069
"1888",1459310104,1,2,2,1,2,8,10,11,10,9,9,49,4,2,0.161255914835654
"1889",1702863678,5,5,5,5,5,25,10,9,10,10,10,49,2,8,-1.20805422690819
"1890",1719959740,2,3,1,1,2,9,8,9,6,8,3,34,4,6,-0.117326657113361
"1891",1625604461,4,3,2,1,3,13,3,4,4,4,4,19,4,4,-0.740599554138976
"1892",1462820754,4,3,3,2,3,15,10,10,8,6,5,39,2,8,-0.929471654959171
"1893",1703621955,4,2,2,2,2,12,5,4,4,2,1,16,3,4,-1.20805422690819
"1894",1290189788,3,3,3,3,3,15,6,9,10,6,7,38,3,4,-1.20805422690819
"1895",1490565428,3,3,3,3,3,15,8,8,8,8,8,40,2,6,0.401970322076069
"1896",1073527089,3,3,3,3,3,15,6,6,6,6,6,30,8,2,1.47074229022351
"1897",1490577945,1,1,1,1,1,5,11,11,11,11,11,55,8,6,-1.20805422690819
"1898",1658886148,3,4,4,5,4,20,7,10,6,6,6,35,1,3,-1.20805422690819
"1899",1649941652,2,3,2,2,3,12,11,11,11,11,11,55,1,5,-1.05223600265178
"1900",1490955639,2,3,3,2,3,13,5,4,5,5,5,24,2,5,-1.20805422690819
"1901",1490759062,1,2,2,1,2,8,5,5,3,3,3,19,2,3,1.47074229022351
"1902",1491739187,2,3,3,2,3,13,6,8,9,6,6,35,3,6,0.161255914835654
"1903",1491563464,4,5,4,3,4,20,11,11,10,11,11,54,1,2,0.0384915671430424
"1904",1491560252,1,1,3,3,4,12,11,11,10,6,9,47,2,7,0.642684729316485
"1905",1490720030,1,3,4,1,2,11,7,7,8,6,7,35,4,6,0.246152097819666
"1906",1544149758,4,3,3,2,3,15,3,5,6,4,8,26,5,4,-1.20805422690819
"1907",1196818793,1,4,4,2,5,16,6,10,7,7,6,36,1,4,0.0384915671430424
"1908",1708655310,3,3,3,3,3,15,6,6,6,6,6,30,1,6,0.656658871028104
"1909",1673501241,3,2,2,2,2,11,6,9,3,4,4,26,1,4,-1.20805422690819
"1910",1491641956,3,4,2,1,1,11,4,5,7,5,2,23,3,7,0.00543769057925059
"1911",1330656337,5,4,3,3,3,18,6,6,6,6,6,30,1,6,1.47074229022351
"1912",1490889510,3,3,3,3,3,15,6,6,6,6,6,30,1,7,0.246152097819666
"1913",1596067063,5,5,4,5,4,23,4,3,2,3,6,18,1,2,-0.428963105626168
"1914",1491156816,3,4,4,4,3,18,6,6,6,6,6,30,5,5,-1.20805422690819
"1915",1684732009,3,3,2,1,1,10,1,5,6,4,4,20,2,3,1.47074229022351
"1916",1490693039,3,3,3,2,2,13,6,7,6,4,3,26,1,6,-0.117326657113361
"1917",1547805412,3,4,4,3,4,18,9,11,10,9,8,47,1,2,0.0384915671430424
"1918",1491495278,1,4,2,3,3,13,6,7,7,6,6,32,4,3,0.161255914835654
"1919",1672019982,5,4,5,5,5,24,6,9,6,9,7,37,4,2,-0.740599554138976
"1920",1653238972,4,4,4,4,4,20,8,9,8,8,8,41,1,4,-0.117326657113361
"1921",1565546563,5,4,4,4,4,21,11,9,8,8,9,45,2,7,-0.844575471975159
"1922",1491545428,1,5,5,5,5,21,11,11,11,11,11,55,3,2,-1.05223600265178
"1923",1677214534,3,4,4,1,3,15,8,9,10,8,8,43,1,4,0.401970322076069
"1924",1690174114,3,5,5,3,5,21,8,7,6,6,7,34,1,7,-0.0654843506931415
"1925",1491518432,4,4,4,2,2,16,9,3,8,8,9,37,2,3,-0.306198757933557
"1926",1681574594,2,2,2,2,5,13,9,8,7,9,9,42,2,3,-1.20805422690819
"1927",1647358656,3,4,3,2,4,16,11,11,6,6,11,45,1,5,0.161255914835654
"1928",1595482566,2,3,2,2,3,12,7,6,5,8,5,31,1,4,1.47074229022351
"1929",1580974511,3,3,3,3,3,15,6,6,6,6,6,30,2,8,-1.05223600265178
"1930",1490967870,4,4,3,3,4,18,6,6,5,6,6,29,1,6,-1.08528987921557
"1931",1708277466,5,4,3,3,4,19,10,11,9,11,11,52,1,4,0.401970322076069
"1932",1490913971,3,3,1,1,4,12,11,11,11,11,11,55,1,6,-0.428963105626168
"1933",1491776321,1,4,3,4,2,14,11,11,9,6,6,43,5,6,0.415944463787689
"1934",1465383102,4,4,4,4,4,20,11,11,10,11,11,54,2,2,-1.20805422690819
"1935",1490717178,1,1,1,1,1,5,8,7,5,6,7,33,1,5,0.161255914835654
"1936",1491471588,3,4,3,3,4,17,2,5,5,6,5,23,1,5,-1.20805422690819
"1937",1491529266,1,1,1,1,1,5,10,7,6,6,6,35,6,8,1.47074229022351
"1938",1490617011,2,3,3,2,3,13,7,7,7,7,7,35,1,6,0.0384915671430424
"1939",1565548027,4,4,4,4,4,20,6,7,7,8,8,36,3,5,-1.20805422690819
"1940",1491518549,1,1,1,1,1,5,7,7,8,5,4,31,1,6,0.642684729316485
"1941",1652833941,1,2,2,2,4,11,8,11,9,8,8,44,1,7,0.161255914835654
"1942",1490807015,3,3,4,3,3,16,8,8,9,7,9,41,2,6,0.246152097819666
"1943",1703787632,1,4,2,1,4,12,7,7,8,3,3,28,2,3,1.12411354379732
"1944",1648247396,4,2,2,2,2,12,7,10,8,9,9,43,2,4,1.12411354379732
"1945",1490586289,3,3,3,3,3,15,6,6,6,6,6,30,1,4,-0.306198757933557
"1946",1670977076,1,1,1,1,1,5,7,9,9,6,4,35,5,5,-1.05223600265178
"1947",1619364237,3,2,2,2,2,11,9,8,9,3,4,33,5,8,-0.740599554138976
"1948",1645993349,4,2,2,1,3,12,11,9,9,9,10,48,5,5,1.47074229022351
"1949",1491117955,1,3,3,1,3,11,8,8,8,8,6,38,5,7,-1.20805422690819
"1950",1490752445,2,3,4,1,3,13,7,8,7,7,8,37,5,4,0.727580912300496
"1951",1654738118,2,4,3,1,2,12,6,6,6,6,6,30,5,6,0.175230056547274
"1952",1491724365,1,3,1,1,1,7,6,7,6,3,1,23,5,6,-1.20805422690819
"1953",1418603676,5,5,5,2,4,21,9,9,8,6,6,38,5,5,-1.20805422690819
"1954",1690370001,3,3,3,3,3,15,6,6,6,6,6,30,5,6,-0.617835206446364
"1955",1490714923,1,1,1,1,1,5,7,7,5,6,7,32,5,8,0.0384915671430424
"1956",1715548781,1,1,2,1,3,8,5,4,6,6,9,30,5,4,0.104308015274882
"1957",1491097758,1,4,2,2,4,13,7,7,7,7,6,34,5,5,-1.20805422690819
"1958",1445492681,1,1,1,1,1,5,4,7,6,5,5,27,5,4,1.47074229022351
"1959",1490645416,1,1,1,1,1,5,5,5,3,2,2,17,5,2,1.12411354379732
"1960",1718308517,3,3,3,3,3,15,6,6,6,6,6,30,5,5,-1.20805422690819
"1961",1491350818,1,1,4,4,4,14,6,6,6,6,6,30,5,3,-1.20805422690819
"1962",1491115246,3,3,3,3,4,16,6,6,6,6,6,30,5,6,-0.117326657113361
"1963",1554544234,1,1,1,1,5,9,11,11,11,11,9,53,5,8,-1.20805422690819
"1964",1710703162,2,5,4,4,4,19,8,11,8,8,9,44,5,4,-0.740599554138976
"1965",1491560503,4,3,4,1,5,17,11,11,11,11,11,55,5,6,0.00543769057925059
"1966",1510674212,3,3,3,3,3,15,6,6,6,6,6,30,5,2,0.642684729316485
"1967",1649518537,5,5,5,5,5,25,8,8,8,8,8,40,5,2,-0.740599554138976
"1968",1491163498,1,3,1,1,2,8,7,8,8,7,9,39,5,7,0.642684729316485
"1969",1490866326,3,2,2,1,2,10,7,7,5,3,3,25,5,8,1.12411354379732
"1970",1491516681,3,3,3,1,3,13,7,7,6,2,2,24,5,7,1.36482795103773
"1971",1478072299,4,3,2,2,4,15,3,1,1,1,1,7,5,6,1.36482795103773
"1972",1582379510,1,2,3,1,3,10,11,11,10,11,11,54,5,7,-0.0654843506931415
"1973",1491512496,1,4,4,3,2,14,1,11,11,6,8,37,5,8,0.401970322076069
"1974",1469863824,4,4,4,4,5,21,5,4,2,3,5,19,5,6,1.47074229022351
"1975",1706383232,3,3,4,3,2,15,8,9,6,7,7,37,5,8,-1.20805422690819
"1976",1520460551,3,3,3,3,3,15,6,6,6,6,6,30,5,6,-1.05223600265178
"1977",1491522125,4,3,3,3,3,16,7,7,7,7,8,36,5,6,-0.428963105626168
"1978",1577369948,3,4,3,2,2,14,11,8,7,5,10,41,5,3,0.161255914835654
"1979",1490973332,5,5,5,5,5,25,4,5,5,5,5,24,5,6,-1.20805422690819
"1980",1491220161,4,3,1,4,5,17,6,7,10,5,9,37,5,7,-0.617835206446364
"1981",1491632907,2,3,4,2,4,15,9,10,7,4,3,33,5,5,0.486866505060081
"1982",1116847011,1,2,3,2,3,11,4,8,2,2,1,17,5,5,-1.20805422690819
"1983",1490980148,3,3,4,4,4,18,7,9,6,8,8,38,5,8,0.401970322076069
"1984",1517551811,3,4,3,3,4,17,7,7,3,3,3,23,5,4,-1.20805422690819
"1985",1435136841,1,4,1,2,1,9,4,5,6,8,4,27,5,8,1.12411354379732
"1986",1491495487,4,2,2,2,2,12,5,5,5,5,8,28,5,4,0.161255914835654
"1987",1698978504,4,5,4,4,5,22,2,4,8,2,3,19,5,3,-1.20805422690819
"1988",1608823257,1,2,1,1,4,9,7,11,8,5,8,39,5,2,-0.117326657113361
"1989",1491545567,1,1,1,1,1,5,9,7,8,8,6,38,5,8,0.00543769057925059
"1990",1490684230,1,2,2,1,1,7,9,7,2,1,1,20,5,4,0.642684729316485
"1991",1491520137,2,2,3,3,3,13,7,7,8,6,6,34,5,6,0.642684729316485
"1992",1491521321,3,3,3,3,3,15,7,10,7,6,6,36,5,2,0.0384915671430424
"1993",1625499955,3,2,2,2,2,11,6,5,6,6,6,29,5,3,-0.428963105626168
"1994",1535388142,5,5,5,5,5,25,9,9,8,8,7,41,5,8,-0.117326657113361
"1995",1491513571,4,5,5,4,4,22,11,11,8,6,5,41,5,3,-1.20805422690819
"1996",1490891616,1,1,1,1,1,5,8,10,5,7,6,36,5,6,-1.20805422690819
"1997",1580925078,1,1,1,1,1,5,9,6,6,6,8,35,5,5,0.0384915671430424
"1998",1448639138,4,3,4,3,3,17,6,7,5,6,6,30,5,4,-1.20805422690819
"1999",1573353083,1,4,3,2,2,12,10,9,7,3,3,32,5,4,0.161255914835654
"2000",1490711936,1,3,1,4,2,11,5,5,2,1,2,15,5,2,0.415944463787689
"2001",1491572732,2,2,3,2,2,11,11,10,8,6,7,42,5,3,0.8833991365569
"2002",1471333698,3,4,2,1,3,13,7,7,5,6,8,33,5,6,-0.363146657494329
"2003",1691894827,2,3,3,3,3,14,7,8,6,6,6,33,5,6,0.161255914835654
"2004",1490614338,4,3,2,2,2,13,8,8,8,7,8,39,5,6,-1.05223600265178
"2005",1685548587,1,2,3,1,3,10,7,6,7,8,6,34,5,3,0.0384915671430424
"2006",1715148466,4,5,4,4,4,21,6,7,7,6,7,33,5,7,-0.428963105626168
"2007",1094817277,1,1,1,1,1,5,7,8,7,1,2,25,5,8,0.161255914835654
"2008",1653292457,2,2,2,2,2,10,9,9,7,7,7,39,5,4,0.0384915671430424
"2009",1472971731,2,1,1,1,1,6,6,6,6,6,6,30,5,6,1.36482795103773
"2010",1708158833,3,3,3,3,3,15,5,5,5,5,5,25,5,4,-0.740599554138976
"2011",1491492030,2,4,4,2,4,16,11,11,11,11,9,53,5,6,-1.20805422690819
"2012",1490640043,2,3,3,2,3,13,11,9,6,6,7,39,5,8,0.0384915671430424
"2013",1282617959,1,1,1,1,1,5,5,5,6,8,8,32,5,4,0.8833991365569
"2014",1642451944,4,4,5,5,4,22,5,6,6,5,5,27,5,7,0.246152097819666
"2015",1565643453,1,3,2,1,3,10,7,9,5,4,3,28,5,4,0.656658871028104
"2016",1490586256,3,4,3,3,3,16,9,10,10,10,10,49,5,4,0.175230056547274
"2017",1491472306,3,4,3,3,3,16,11,11,7,1,3,33,5,3,0.161255914835654
"2018",1490580751,3,4,3,3,5,18,8,10,9,8,7,42,5,2,-0.740599554138976
"2019",1491624545,1,4,2,4,4,15,8,9,7,7,7,38,5,4,-0.117326657113361
"2020",1626272707,1,4,4,4,3,16,9,10,9,8,7,43,5,3,0.401970322076069
"2021",1638683224,4,4,4,4,4,20,10,10,8,6,7,41,5,8,0.0384915671430424
"2022",1490715948,2,2,2,2,2,10,8,8,4,6,7,33,5,6,1.36482795103773
"2023",1491506237,3,3,3,3,3,15,6,6,6,6,6,30,5,5,1.47074229022351
"2024",1491524749,2,4,4,4,3,17,11,11,8,6,7,43,5,5,-1.20805422690819
"2025",1716909959,1,1,1,1,1,5,11,11,9,7,6,44,5,6,1.12411354379732
